,date,tournament,home_team,away_team,home_team_rating,away_team_rating,home_goals,away_goals,home_team_rating_change,away_team_rating_change,home_team_new_rating,away_team_new_rating,home_team_rank,away_team_rank,home_team_rank_change,away_team_rank_change,home_team_new_rank,away_team_new_rank,k,hadv,rdiff
0,Jan 2 2010,Friendly tournament in Qatar,Iran,North Korea,1634,1554,1,0,12,-12,1646,1542,48,85,1,-6,49,79,30,0,80
1,Jan 2 2010,Friendly tournament in Qatar,Qatar,Mali,1530,1571,0,0,-3,3,1527,1574,84,68,-1,0,83,68,30,100,59
2,Jan 2 2010,Friendly in Malaysia,Syria,Zimbabwe,1546,1341,6,0,10,-10,1556,1331,69,127,4,-3,73,124,20,0,205
3,Jan 2 2010,Friendly in Yemen,Yemen,Tajikistan,1233,1264,0,1,-12,12,1221,1276,152,133,-2,2,150,135,20,100,69
4,Jan 3 2010,Friendly in Portugal,Angola,Gambia,1446,1393,1,1,-2,2,1444,1395,102,113,-1,0,101,113,20,0,53
5,Jan 3 2010,Friendly in South Africa,Gabon,Mozambique,1534,1427,1,0,7,-7,1541,1420,79,108,1,-1,80,107,20,0,107
6,Jan 4 2010,Friendly in the United Arab Emirates,Egypt,Mali,1696,1574,1,0,7,-7,1703,1567,39,72,1,-2,40,70,20,0,122
7,Jan 4 2010,Friendly in Tanzania,Tanzania,Ivory Coast,1344,1761,0,1,-3,3,1341,1764,120,28,0,0,120,28,20,100,-317
8,Jan 5 2010,Friendly in Swaziland,Ghana,Malawi,1686,1356,0,0,-7,7,1679,1363,46,117,-2,1,44,118,20,0,330
9,Jan 6 2010,Asian Cup qualifier in Bahrain,Bahrain,Hong Kong,1616,1221,4,0,4,-4,1620,1217,54,156,0,-3,54,153,40,100,495
10,Jan 6 2010,Friendly in Benin,Benin,Libya,1459,1493,1,0,8,-8,1467,1485,92,91,2,-2,94,89,20,100,66
11,Jan 6 2010,Asian Cup qualifier in China,China,Syria,1545,1556,0,0,-5,5,1540,1561,83,71,-3,1,80,72,40,100,89
12,Jan 6 2010,Friendly in South Africa,Gabon,Mozambique,1541,1420,2,0,10,-10,1551,1410,68,111,6,-2,74,109,20,0,121
13,Jan 6 2010,Asian Cup qualifier in Indonesia,Indonesia,Oman,1267,1597,1,2,-8,8,1259,1605,139,57,-1,1,138,58,40,100,-230
14,Jan 6 2010,Asian Cup qualifier in Kuwait,Kuwait,Australia,1475,1789,2,2,11,-11,1486,1778,85,27,3,-4,88,23,30,0,-314
15,Jan 6 2010,Asian Cup qualifier in Lebanon,Lebanon,Vietnam,1226,1362,1,1,2,-2,1228,1360,149,119,0,0,149,119,30,100,-36
16,Jan 6 2010,Friendly in South Africa,Nigeria,Zambia,1748,1497,0,0,-6,6,1742,1503,40,86,-4,0,36,86,20,0,251
17,Jan 6 2010,Asian Cup qualifier in Singapore,Singapore,Iran,1397,1646,1,3,-18,18,1379,1664,118,47,-3,1,115,48,40,100,-149
18,Jan 6 2010,Asian Cup qualifier in Thailand,Thailand,Jordan,1475,1460,0,0,-6,6,1469,1466,93,95,-1,0,92,95,40,100,115
19,Jan 6 2010,Asian Cup qualifier in the United Arab Emirates,United Arab Emirates,Malaysia,1398,1173,1,0,5,-5,1403,1168,111,165,0,-1,111,164,40,100,325
20,Jan 6 2010,Asian Cup qualifier in Yemen,Yemen,Japan,1221,1788,2,3,-3,3,1218,1791,152,18,-1,1,151,19,40,100,-467
21,Jan 7 2010,Friendly in Tanzania,Ivory Coast,Rwanda,1764,1405,2,0,3,-3,1767,1402,26,112,1,-1,27,111,20,0,359
22,Jan 9 2010,Friendly in Kenya,Kenya,Cameroon,1338,1774,1,3,-4,4,1334,1778,122,21,0,2,122,23,20,100,-336
23,Jan 9 2010,Friendly in Tunisia,Tunisia,Gambia,1627,1395,1,2,-17,17,1610,1412,58,106,-3,3,55,109,20,100,332
24,Jan 9 2010,Friendly in South Africa,Zambia,South Korea,1503,1748,4,2,24,-24,1527,1724,80,40,3,-4,83,36,20,0,-245
25,Jan 10 2010,African Nations Cup in Angola,Angola,Mali,1444,1567,4,4,2,-2,1446,1565,99,70,1,0,100,70,50,100,-23
26,Jan 11 2010,African Nations Cup in Angola,Burkina Faso,Ivory Coast,1477,1767,0,0,17,-17,1494,1750,84,35,3,-4,87,31,50,0,-290
27,Jan 11 2010,African Nations Cup in Angola,Malawi,Algeria,1363,1584,3,0,68,-68,1431,1516,90,106,14,-21,104,85,50,0,-221
28,Jan 12 2010,African Nations Cup in Angola,Benin,Mozambique,1467,1410,2,2,-4,4,1463,1414,96,109,-1,1,95,110,20,100,157
29,Jan 12 2010,African Nations Cup in Angola,Egypt,Nigeria,1703,1742,3,1,42,-42,1745,1700,30,47,5,-6,35,41,50,0,-39
30,Jan 13 2010,African Nations Cup in Angola,Gabon,Cameroon,1551,1778,1,0,39,-39,1590,1739,47,47,13,-12,60,35,50,0,-227
31,Jan 13 2010,African Nations Cup in Angola,Tunisia,Zambia,1610,1527,1,1,-6,6,1604,1533,61,80,-3,1,58,81,50,0,83
32,Jan 14 2010,African Nations Cup in Angola,Algeria,Mali,1516,1565,1,0,29,-29,1545,1536,67,92,9,-11,76,81,50,0,-49
33,Jan 14 2010,African Nations Cup in Angola,Angola,Malawi,1446,1431,2,0,26,-26,1472,1405,84,118,8,-7,92,111,50,100,115
34,Jan 15 2010,African Nations Cup in Angola,Ivory Coast,Ghana,1750,1679,3,1,30,-30,1780,1649,16,54,7,-5,23,49,50,0,71
35,Jan 15 2010,Friendly in Yemen,Yemen,Kenya,1218,1334,3,1,16,-16,1234,1318,145,130,3,-4,148,126,20,100,-16
36,Jan 16 2010,African Nations Cup in Angola,Egypt,Mozambique,1745,1414,2,0,10,-10,1755,1404,28,113,3,-2,31,111,50,0,331
37,Jan 16 2010,African Nations Cup in Angola,Nigeria,Benin,1700,1463,1,0,10,-10,1710,1453,39,100,1,-2,40,98,50,0,237
38,Jan 16 2010,Friendly in Taiwan,Taiwan,Philippines,928,816,0,0,-5,5,923,821,198,206,-2,0,196,206,20,100,212
39,Jan 17 2010,African Nations Cup in Angola,Cameroon,Zambia,1739,1533,3,2,12,-12,1751,1521,29,86,3,-2,32,84,50,0,206
40,Jan 17 2010,African Nations Cup in Angola,Gabon,Tunisia,1590,1604,0,0,1,-1,1591,1603,60,58,0,0,60,58,30,0,-14
41,Jan 17 2010,King's Cup in Thailand,Thailand,Singapore,1469,1379,1,0,8,-8,1477,1371,89,118,2,-1,91,117,30,100,190
42,Jan 17 2010,Asian Cup qualifier in Vietnam,Vietnam,China,1360,1540,1,2,-15,15,1345,1555,119,67,0,6,119,73,40,100,-80
43,Jan 18 2010,African Nations Cup in Angola,Angola,Algeria,1472,1545,0,0,-2,2,1470,1547,93,77,0,0,93,77,40,100,27
44,Jan 18 2010,African Nations Cup in Angola,Mali,Malawi,1536,1405,3,1,24,-24,1560,1381,63,118,9,-4,72,114,50,0,131
45,Jan 18 2010,Friendly in Spain,South Korea,Finland,1724,1680,2,0,13,-13,1737,1667,36,47,0,-2,36,45,20,0,44
46,Jan 19 2010,African Nations Cup in Angola,Ghana,Burkina Faso,1649,1494,1,0,15,-15,1664,1479,45,93,2,-3,47,90,50,0,155
47,Jan 20 2010,Friendly in Chile,Chile,Panama,1880,1551,2,1,2,-2,1882,1549,11,75,0,0,11,75,20,100,429
48,Jan 20 2010,African Nations Cup in Angola,Egypt,Benin,1755,1453,2,0,11,-11,1766,1442,25,104,3,-3,28,101,50,0,302
49,Jan 20 2010,African Nations Cup in Angola,Nigeria,Mozambique,1710,1404,3,0,13,-13,1723,1391,34,114,3,-2,37,112,50,0,306
50,Jan 20 2010,Friendly in Oman,Oman,Sweden,1605,1772,0,1,-8,8,1597,1780,59,20,-1,3,58,23,20,100,-67
51,Jan 20 2010,King's Cup in Thailand,Thailand,Poland,1477,1633,1,3,-19,19,1458,1652,101,49,-5,1,96,50,30,100,-56
52,Jan 20 2010,Asian Cup qualifier in Yemen,Yemen,Bahrain,1234,1620,3,0,59,-59,1293,1561,118,87,15,-17,133,70,40,100,-286
53,Jan 21 2010,African Nations Cup in Angola,Cameroon,Tunisia,1751,1603,2,2,-10,10,1741,1613,38,50,-3,3,35,53,50,0,148
54,Jan 21 2010,African Nations Cup in Angola,Zambia,Gabon,1521,1591,2,1,30,-30,1551,1561,66,79,9,-10,75,69,50,0,-70
55,Jan 22 2010,Friendly in Spain,South Korea,Latvia,1737,1569,1,0,6,-6,1743,1563,34,70,1,-2,35,68,20,0,168
56,Jan 23 2010,King's Cup in Thailand,Poland,Singapore,1652,1371,6,1,10,-10,1662,1361,50,119,0,-1,50,118,30,0,281
57,Jan 23 2010,Friendly in South Africa,South Africa,Swaziland,1521,1172,6,2,3,-3,1524,1169,85,163,0,0,85,163,20,100,449
58,Jan 23 2010,Friendly in Syria,Syria,Sweden,1561,1780,1,1,3,-3,1564,1777,65,27,2,-2,67,25,20,100,-119
59,Jan 23 2010,Friendly in the United States,United States,Honduras,1803,1747,1,3,-21,21,1782,1768,27,20,-5,7,22,27,20,100,156
60,Jan 24 2010,African Nations Cup in Angola,Algeria,Ivory Coast,1547,1780,3,2,40,-40,1587,1740,42,49,18,-13,60,36,50,0,-233
61,Jan 24 2010,African Nations Cup in Angola,Angola,Ghana,1470,1664,0,1,-18,18,1452,1682,102,39,-5,4,97,43,50,100,-94
62,Jan 25 2010,African Nations Cup in Angola,Egypt,Cameroon,1766,1741,3,1,35,-35,1801,1706,6,45,11,-5,17,40,50,0,25
63,Jan 25 2010,African Nations Cup in Angola,Nigeria,Zambia,1723,1551,0,0,-11,11,1712,1562,41,66,-2,5,39,71,50,0,172
64,Jan 26 2010,Friendly in Argentina,Argentina,Costa Rica,1896,1703,3,2,3,-3,1899,1700,7,41,0,0,7,41,20,100,293
65,Jan 27 2010,Friendly in South Africa,South Africa,Zimbabwe,1524,1331,3,0,5,-5,1529,1326,81,123,2,0,83,123,20,100,293
66,Jan 28 2010,African Nations Cup in Angola,Egypt,Algeria,1801,1587,4,0,21,-21,1822,1566,13,74,2,-7,15,67,50,0,214
67,Jan 28 2010,African Nations Cup in Angola,Ghana,Nigeria,1682,1712,1,0,27,-27,1709,1685,35,45,4,-3,39,42,50,0,-30
68,Jan 30 2010,African Nations Cup in Angola,Nigeria,Algeria,1685,1566,1,0,17,-17,1702,1549,40,85,1,-9,41,76,50,0,119
69,Jan 31 2010,African Nations Cup in Angola,Egypt,Ghana,1822,1709,1,0,17,-17,1839,1692,13,45,1,-3,14,42,50,0,113
70,Jan 31 2010,Friendly in Jamaica,Jamaica,Canada,1622,1606,1,0,7,-7,1629,1599,52,59,0,-2,52,57,20,100,116
71,Feb 2 2010,Friendly in Japan,Japan,Venezuela,1791,1722,0,0,-5,5,1786,1727,19,36,0,0,19,36,20,100,169
72,Feb 6 2010,East Asian Championship in Japan,Japan,China,1786,1555,0,0,-15,15,1771,1570,33,57,-7,9,26,66,40,100,331
73,Feb 7 2010,East Asian Championship in Japan,South Korea,Hong Kong,1743,1217,5,0,4,-4,1747,1213,34,153,0,0,34,153,40,0,526
74,Feb 10 2010,Friendly tournament in Argentina,Argentina,Jamaica,1899,1629,2,1,3,-3,1902,1626,7,52,0,0,7,52,20,0,270
75,Feb 10 2010,East Asian Championship in Japan,China,South Korea,1570,1747,3,0,51,-51,1621,1696,40,48,13,-7,53,41,40,0,-177
76,Feb 11 2010,East Asian Championship in Japan,Japan,Hong Kong,1771,1213,3,0,2,-2,1773,1211,26,155,0,-1,26,154,30,0,558
77,Feb 14 2010,East Asian Championship in Japan,China,Hong Kong,1621,1211,2,0,5,-5,1626,1206,51,158,1,-2,52,156,40,0,410
78,Feb 14 2010,East Asian Championship in Japan,Japan,South Korea,1773,1696,1,3,-44,44,1729,1740,44,25,-9,8,35,33,40,100,177
79,Feb 16 2010,Asian Cup q & Asian Chlg Cup in Sri Lanka,Bangladesh,Tajikistan,929,1276,2,1,35,-35,964,1241,187,152,3,-8,190,144,40,0,-347
80,Feb 16 2010,Asian Cup q & Asian Chlg Cup in Sri Lanka,Sri Lanka,Myanmar,937,1189,0,4,-22,22,915,1211,201,150,-5,4,196,154,40,100,-152
81,Feb 17 2010,Friendly in Kosovo,Kosovo,Albania,1389,1487,2,3,-10,10,1379,1497,117,87,-2,0,115,87,20,100,2
82,Feb 17 2010,Asian Cup q & Asian Chlg Cup in Sri Lanka,Kyrgyzstan,India,1162,1219,2,1,23,-23,1185,1196,152,163,7,-6,159,157,40,0,-57
83,Feb 17 2010,Asian Cup q & Asian Chlg Cup in Sri Lanka,North Korea,Turkmenistan,1542,1298,1,1,-12,12,1530,1310,83,130,-1,1,82,131,40,0,244
84,Feb 18 2010,Asian Cup q & Asian Chlg Cup in Sri Lanka,Myanmar,Bangladesh,1211,964,2,1,8,-8,1219,956,149,190,2,0,151,190,40,0,247
85,Feb 18 2010,Asian Cup q & Asian Chlg Cup in Sri Lanka,Sri Lanka,Tajikistan,915,1241,1,3,-13,13,902,1254,200,136,-2,4,198,140,40,100,-226
86,Feb 19 2010,Friendly in the United Arab Emirates,Kuwait,Syria,1486,1564,1,1,2,-2,1488,1562,88,72,0,-2,88,70,20,0,-78
87,Feb 19 2010,Asian Cup q & Asian Chlg Cup in Sri Lanka,North Korea,Kyrgyzstan,1530,1185,4,0,9,-9,1539,1176,82,165,0,-3,82,162,40,0,345
88,Feb 19 2010,Asian Cup q & Asian Chlg Cup in Sri Lanka,Turkmenistan,India,1310,1196,1,0,14,-14,1324,1182,117,159,7,-1,124,158,40,0,114
89,Feb 20 2010,Asian Cup q & Asian Chlg Cup in Sri Lanka,Sri Lanka,Bangladesh,902,956,3,0,30,-30,932,926,186,200,6,-5,192,195,30,0,-54
90,Feb 20 2010,Asian Cup q & Asian Chlg Cup in Sri Lanka,Tajikistan,Myanmar,1254,1219,3,0,31,-31,1285,1188,132,163,4,-6,136,157,40,0,35
91,Feb 21 2010,Asian Cup q & Asian Chlg Cup in Sri Lanka,North Korea,India,1539,1182,3,0,8,-8,1547,1174,76,166,3,-4,79,162,40,0,357
92,Feb 21 2010,Asian Cup q & Asian Chlg Cup in Sri Lanka,Turkmenistan,Kyrgyzstan,1324,1176,1,0,12,-12,1336,1164,120,168,2,-3,122,165,40,0,148
93,Feb 24 2010,Friendly in the United States,Mexico,Bolivia,1891,1601,5,0,6,-6,1897,1595,8,61,0,-2,8,59,20,0,290
94,Feb 24 2010,Asian Cup q & Asian Chlg Cup in Sri Lanka,North Korea,Myanmar,1547,1188,5,0,9,-9,1556,1179,73,159,3,-1,76,158,40,0,359
95,Feb 24 2010,Asian Cup q & Asian Chlg Cup in Sri Lanka,Turkmenistan,Tajikistan,1336,1285,2,0,26,-26,1362,1259,114,140,4,-2,118,138,40,0,51
96,Feb 24 2010,Friendly in the United States,United States,El Salvador,1782,1515,2,1,2,-2,1784,1513,16,86,3,0,19,86,20,100,367
97,Feb 25 2010,Friendly in Jordan,Jordan,Azerbaijan,1466,1419,0,2,-21,21,1445,1440,107,99,-7,4,100,103,20,100,147
98,Feb 25 2010,Friendly in the United Arab Emirates,Kuwait,Bahrain,1488,1561,4,1,21,-21,1509,1540,86,90,1,-9,87,81,20,0,-73
99,Feb 27 2010,Friendly in Malaysia,Malaysia,Yemen,1168,1293,1,0,11,-11,1179,1282,152,137,6,-2,158,135,20,100,-25
100,Feb 27 2010,Asian Cup q & Asian Chlg Cup in Sri Lanka,North Korea,Turkmenistan,1556,1362,1,1,-10,10,1546,1372,83,116,-4,1,79,117,30,100,294
101,Feb 27 2010,Asian Cup q & Asian Chlg Cup in Sri Lanka,Tajikistan,Myanmar,1259,1179,1,0,15,-15,1274,1164,134,170,2,-6,136,164,40,0,80
102,Feb 28 2010,Friendly in Curaçao,Curaçao,Bonaire,1126,1104,4,0,12,-12,1138,1092,169,178,2,-1,171,177,20,100,122
103,Mar 2 2010,Friendly in England,Brazil,Ireland,2104,1767,2,0,4,-4,2108,1763,1,27,0,0,1,27,20,0,337
104,Mar 2 2010,Friendly in Guadeloupe,Guadeloupe,Saint Kitts and Nevis,1468,1138,2,1,2,-2,1470,1136,92,173,0,-1,92,172,20,100,430
105,Mar 3 2010,Friendly in Albania,Albania,Northern Ireland,1497,1577,1,0,9,-9,1506,1568,86,71,1,-3,87,68,20,100,20
106,Mar 3 2010,Friendly in Algeria,Algeria,Serbia,1549,1834,0,3,-9,9,1540,1843,83,13,-4,1,79,14,20,100,-185
107,Mar 3 2010,Friendly in Angola,Angola,Latvia,1452,1563,1,1,0,0,1452,1563,96,73,0,-2,96,71,20,100,-11
108,Mar 3 2010,Asian Cup qualifier in Australia,Australia,Indonesia,1778,1259,1,0,1,-1,1779,1258,21,139,1,0,22,139,20,0,519
109,Mar 3 2010,Friendly in Austria,Austria,Denmark,1588,1811,2,1,13,-13,1601,1798,52,17,4,0,56,17,20,100,-123
110,Mar 3 2010,Friendly in Turkey,Belarus,Armenia,1581,1380,3,1,7,-7,1588,1373,56,116,4,-1,60,115,20,0,201
111,Mar 3 2010,Friendly in Belgium,Belgium,Croatia,1587,1888,0,1,-5,5,1582,1893,69,8,-4,1,65,9,20,100,-201
112,Mar 3 2010,Friendly in Bosnia and Herzegovina,Bosnia and Herzegovina,Ghana,1641,1692,2,1,9,-9,1650,1683,51,42,0,0,51,42,20,100,49
113,Mar 3 2010,Friendly in Monaco,Cameroon,Italy,1706,1957,0,0,6,-6,1712,1951,37,4,1,1,38,5,20,0,-251
114,Mar 3 2010,Friendly in Cyprus,Cyprus,Iceland,1564,1446,0,0,-6,6,1558,1452,80,93,-6,3,74,96,20,100,218
115,Mar 3 2010,Friendly in England,England,Egypt,1985,1839,3,1,6,-6,1991,1833,4,16,0,-1,4,15,20,100,246
116,Mar 3 2010,Friendly in France,France,Spain,1891,2095,0,2,-11,11,1880,2106,13,2,-2,0,11,2,20,100,-104
117,Mar 3 2010,Friendly in Georgia,Georgia,Estonia,1435,1451,2,1,8,-8,1443,1443,100,107,2,-5,102,102,20,100,84
118,Mar 3 2010,Friendly in Germany,Germany,Argentina,1962,1902,0,1,-14,14,1948,1916,7,7,-1,0,6,7,20,100,160
119,Mar 3 2010,Friendly in Greece,Greece,Senegal,1783,1545,0,2,-26,26,1757,1571,37,52,-8,14,29,66,20,100,338
120,Mar 3 2010,Friendly in the United States,Guatemala,El Salvador,1425,1513,2,1,12,-12,1437,1501,103,90,2,-2,105,88,20,0,-88
121,Mar 3 2010,Asian Cup qualifier in Hong Kong,Hong Kong,Yemen,1206,1282,0,0,-1,1,1205,1283,155,135,0,0,155,135,20,100,24
122,Mar 3 2010,Friendly in Hungary,Hungary,Russia,1611,1852,1,1,4,-4,1615,1848,53,13,1,0,54,13,20,100,-141
123,Mar 3 2010,Asian Cup qualifier in Iran,Iran,Thailand,1664,1458,1,0,6,-6,1670,1452,46,98,1,-2,47,96,40,100,306
124,Mar 3 2010,Asian Cup qualifier in Japan,Japan,Bahrain,1729,1540,2,0,10,-10,1739,1530,31,81,2,0,33,81,40,100,289
125,Mar 3 2010,Asian Cup qualifier in Jordan,Jordan,Singapore,1445,1361,2,1,10,-10,1455,1351,88,119,6,0,94,119,40,100,184
126,Mar 3 2010,Friendly in Libya,Libya,Mali,1485,1560,2,1,9,-9,1494,1551,89,81,0,-4,89,77,20,100,25
127,Mar 3 2010,Friendly in Luxembourg,Luxembourg,Azerbaijan,1101,1440,1,2,-4,4,1097,1444,176,99,0,2,176,101,20,100,-239
128,Mar 3 2010,Friendly in Macedonia,Macedonia,Montenegro,1576,1667,2,1,10,-10,1586,1657,60,52,3,-3,63,49,20,100,9
129,Mar 3 2010,Friendly in Malta,Malta,Finland,1218,1667,1,2,-2,2,1216,1669,151,50,0,-2,151,48,20,100,-349
130,Mar 3 2010,Friendly in the United States,Mexico,New Zealand,1897,1529,2,0,3,-3,1900,1526,8,81,0,1,8,82,20,0,368
131,Mar 3 2010,Friendly in Turkey,Moldova,Kazakhstan,1442,1341,1,0,7,-7,1449,1334,97,123,2,-1,99,122,20,0,101
132,Mar 3 2010,Friendly in Mozambique,Mozambique,Botswana,1391,1293,0,1,-15,15,1376,1308,114,131,-1,1,113,132,20,100,198
133,Mar 3 2010,Friendly in the Netherlands,Netherlands,United States,2032,1784,2,1,2,-2,2034,1782,3,23,0,-2,3,21,20,100,348
134,Mar 3 2010,Friendly in Nigeria,Nigeria,DR Congo,1702,1429,5,2,4,-4,1706,1425,40,110,0,-2,40,108,20,100,373
135,Mar 3 2010,Asian Cup qualifier in Oman,Oman,Kuwait,1597,1509,0,0,-10,10,1587,1519,64,83,-3,2,61,85,40,100,188
136,Mar 3 2010,Friendly in Poland,Poland,Bulgaria,1662,1758,2,0,15,-15,1677,1743,42,34,4,-2,46,32,20,100,4
137,Mar 3 2010,Friendly in Portugal,Portugal,China,1873,1626,2,0,4,-4,1877,1622,12,54,0,-1,12,53,20,100,347
138,Mar 3 2010,Friendly in Romania,Romania,Israel,1775,1717,0,2,-21,21,1754,1738,37,32,-6,3,31,35,20,100,158
139,Mar 3 2010,Friendly in Scotland,Scotland,Czechia,1671,1748,1,0,9,-9,1680,1739,45,35,0,-2,45,33,20,100,23
140,Mar 3 2010,Friendly in Slovakia,Slovakia,Norway,1664,1748,0,1,-10,10,1654,1758,52,23,-2,4,50,27,20,100,16
141,Mar 3 2010,Friendly in Slovenia,Slovenia,Qatar,1674,1527,4,1,7,-7,1681,1520,44,83,0,1,44,84,20,100,247
142,Mar 3 2010,Friendly in South Africa,South Africa,Namibia,1529,1320,1,1,-7,7,1522,1327,83,124,0,1,83,125,20,100,309
143,Mar 3 2010,Friendly in England,South Korea,Ivory Coast,1740,1740,2,0,15,-15,1755,1725,27,39,3,-3,30,36,20,0,0
144,Mar 3 2010,Friendly in Switzerland,Switzerland,Uruguay,1792,1813,1,3,-18,18,1774,1831,28,16,-5,0,23,16,20,100,79
145,Mar 3 2010,Asian Cup qualifier in Syria,Syria,Lebanon,1562,1228,4,0,6,-6,1568,1222,66,150,2,0,68,150,40,100,434
146,Mar 3 2010,Friendly in Tanzania,Tanzania,Uganda,1341,1548,2,3,-7,7,1334,1555,123,75,-1,1,122,76,20,100,-107
147,Mar 3 2010,Friendly in Turkey,Turkey,Honduras,1784,1768,2,0,10,-10,1794,1758,17,28,1,-1,18,27,20,100,116
148,Mar 3 2010,Asian Cup qualifier in Uzbekistan,Uzbekistan,United Arab Emirates,1547,1403,0,1,-32,32,1515,1435,94,102,-8,4,86,106,40,100,244
149,Mar 3 2010,Friendly in Venezuela,Venezuela,Panama,1727,1549,1,2,-17,17,1710,1566,42,65,-3,5,39,70,20,100,278
150,Mar 3 2010,Friendly in Wales,Wales,Sweden,1606,1777,0,1,-8,8,1598,1785,60,14,-2,5,58,19,20,100,-71
151,Mar 3 2010,Friendly in Zimbabwe,Zimbabwe,Malawi,1326,1381,2,1,9,-9,1335,1372,118,119,3,-3,121,116,20,100,45
152,Mar 4 2010,Friendly in Venezuela,Venezuela,North Korea,1710,1546,1,1,-6,6,1704,1552,41,76,-1,1,40,77,20,100,264
153,Mar 6 2010,Friendly in Sierra Leone,Sierra Leone,Guinea,1248,1477,1,0,14,-14,1262,1463,134,93,4,-1,138,92,20,100,-129
154,Mar 6 2010,Friendly in Venezuela,Venezuela,North Korea,1704,1552,2,1,4,-4,1708,1548,38,79,1,-1,39,78,20,100,252
155,Mar 7 2010,Friendly in Niger,Niger,Benin,1242,1442,2,0,19,-19,1261,1423,134,112,5,-4,139,108,20,100,-100
156,Mar 7 2010,Friendly in Sierra Leone,Sierra Leone,Guinea,1262,1463,0,0,3,-3,1265,1460,138,94,0,-1,138,93,20,100,-101
157,Mar 17 2010,Friendly in Mexico,Mexico,North Korea,1900,1548,2,1,1,-1,1901,1547,8,78,0,0,8,78,20,100,452
158,Mar 21 2010,Friendly in Iceland,Iceland,Faroe Islands,1452,1212,2,0,4,-4,1456,1208,92,156,2,-2,94,154,20,100,340
159,Mar 21 2010,Friendly in Namibia,Namibia,Botswana,1327,1308,0,0,-3,3,1324,1311,125,126,0,3,125,129,20,100,119
160,Mar 24 2010,Friendly in the United States,Iceland,Mexico,1456,1901,0,0,9,-9,1465,1892,90,10,2,-1,92,9,20,0,-445
161,Mar 24 2010,Friendly in Martinique,Martinique,Haiti,1375,1431,0,0,-1,1,1374,1432,114,106,0,0,114,106,20,100,44
162,Mar 31 2010,Friendly in Chile,Chile,Venezuela,1882,1708,0,0,-7,7,1875,1715,14,37,-2,1,12,38,20,100,274
163,Mar 31 2010,Friendly in Paraguay,Paraguay,South Africa,1760,1522,1,1,-7,7,1753,1529,37,81,-6,1,31,82,20,100,338
164,Apr 3 2010,Friendly in Saint Kitts and Nevis,Saint Kitts and Nevis,Guadeloupe,1136,1470,3,0,28,-28,1164,1442,156,115,8,-12,164,103,20,100,-234
165,Apr 7 2010,Friendly in Japan,Japan,Serbia,1739,1843,0,3,-17,17,1722,1860,39,12,-3,1,36,13,20,100,-4
166,Apr 21 2010,Friendly in Honduras,Honduras,Venezuela,1758,1715,0,1,-14,14,1744,1729,36,32,-5,3,31,35,20,100,143
167,Apr 22 2010,Friendly in Germany,North Korea,South Africa,1547,1529,0,0,-1,1,1546,1530,78,80,0,1,78,81,20,0,18
168,Apr 28 2010,Friendly in Germany,South Africa,Jamaica,1530,1626,2,0,19,-19,1549,1607,75,58,3,-3,78,55,20,0,-96
169,May 5 2010,Friendly in Argentina,Argentina,Haiti,1916,1432,4,0,1,-1,1917,1431,7,106,0,0,7,106,20,100,584
170,May 5 2010,Friendly in Chile,Chile,Trinidad and Tobago,1875,1540,2,0,2,-2,1877,1538,10,82,1,-1,11,81,20,100,435
171,May 7 2010,Friendly in the United States,Ecuador,Mexico,1722,1892,0,0,5,-5,1727,1887,35,9,1,0,36,9,20,0,-170
172,May 10 2010,Friendly in the United States,Mexico,Senegal,1887,1571,1,0,3,-3,1890,1568,9,68,0,-1,9,67,20,0,316
173,May 12 2010,Friendly in Yemen,Yemen,Malawi,1283,1372,1,0,10,-10,1293,1362,133,120,1,-2,134,118,20,100,11
174,May 13 2010,Friendly in Germany,Germany,Malta,1948,1216,3,0,0,0,1948,1216,6,151,0,0,6,151,20,100,832
175,May 13 2010,Friendly in the United States,Mexico,Angola,1890,1452,1,0,1,-1,1891,1451,9,98,0,-1,9,97,20,0,438
176,May 15 2010,Friendly in Switzerland,Paraguay,North Korea,1753,1546,1,0,5,-5,1758,1541,22,79,4,0,26,79,20,0,207
177,May 16 2010,Friendly in Mexico,Mexico,Chile,1891,1877,1,0,7,-7,1898,1870,7,13,1,-1,8,12,20,100,114
178,May 16 2010,Friendly in South Africa,South Africa,Thailand,1549,1452,4,0,9,-9,1558,1443,70,104,4,-4,74,100,20,100,197
179,May 16 2010,Friendly in South Korea,South Korea,Ecuador,1755,1727,2,0,10,-10,1765,1717,19,40,5,-2,24,38,20,100,128
180,May 18 2010,Friendly tournament in Yemen,Yemen,Oman,1293,1587,0,1,-7,7,1286,1594,134,59,0,1,134,60,30,100,-194
181,May 19 2010,Friendly in Austria,Austria,Croatia,1601,1893,0,1,-5,5,1596,1898,60,7,-2,1,58,8,20,100,-192
182,May 19 2010,Friendly in Belgium,Belgium,Bulgaria,1582,1743,2,1,12,-12,1594,1731,55,36,5,-2,60,34,20,100,-61
183,May 19 2010,Friendly tournament in France,Gabon,Togo,1561,1463,3,0,19,-19,1580,1444,59,104,7,-6,66,98,30,0,98
184,May 20 2010,Friendly in Aruba,Aruba,Venezuela,908,1729,0,3,-1,1,907,1730,198,35,0,0,198,35,20,100,-721
185,May 20 2010,Friendly tournament in Yemen,Yemen,Burkina Faso,1286,1479,2,2,4,-4,1290,1475,134,90,0,0,134,90,30,100,-93
186,May 21 2010,Friendly in Estonia,Estonia,Finland,1443,1669,2,0,20,-20,1463,1649,84,54,8,-3,92,51,20,100,-126
187,May 21 2010,Friendly in Austria,Saudi Arabia,DR Congo,1683,1425,2,0,6,-6,1689,1419,42,109,0,-1,42,108,20,0,258
188,May 22 2010,Friendly tournament in Yemen,Oman,Burkina Faso,1594,1475,2,0,15,-15,1609,1460,50,94,5,-2,55,92,30,0,119
189,May 22 2010,Friendly in the United States,Turkey,Czechia,1794,1739,2,1,8,-8,1802,1731,16,34,1,-1,17,33,20,0,55
190,May 23 2010,Friendly in Croatia,Croatia,Wales,1898,1598,2,0,3,-3,1901,1595,8,60,0,-1,8,59,20,100,400
191,May 24 2010,Friendly in Argentina,Argentina,Canada,1917,1599,5,0,3,-3,1920,1596,7,57,0,0,7,57,20,100,418
192,May 24 2010,Friendly in Australia,Australia,New Zealand,1779,1526,2,1,2,-2,1781,1524,24,83,-1,0,23,83,20,100,353
193,May 24 2010,Friendly in England,England,Mexico,1991,1898,3,1,7,-7,1998,1891,4,9,0,0,4,9,20,100,193
194,May 24 2010,Friendly in Japan,Japan,South Korea,1722,1765,0,2,-17,17,1705,1782,43,18,-3,3,40,21,20,100,57
195,May 24 2010,Friendly in Portugal,Portugal,Cape Verde,1877,1364,0,0,-9,9,1868,1373,13,113,-1,2,12,115,20,0,513
196,May 24 2010,Friendly in South Africa,South Africa,Bulgaria,1558,1731,1,1,2,-2,1560,1729,74,37,0,-2,74,35,20,100,-73
197,May 25 2010,Friendly in Armenia,Armenia,Uzbekistan,1373,1515,3,1,17,-17,1390,1498,109,90,3,-2,112,88,20,100,-42
198,May 25 2010,Friendly in Austria,Cameroon,Georgia,1712,1443,0,0,-6,6,1706,1449,38,93,0,4,38,97,20,0,269
199,May 25 2010,Friendly in Austria,Greece,North Korea,1757,1541,2,2,-6,6,1751,1547,31,79,-1,0,30,79,20,0,216
200,May 25 2010,Friendly in Ireland,Ireland,Paraguay,1763,1758,2,1,7,-7,1770,1751,23,33,1,-3,24,30,20,100,105
201,May 25 2010,Friendly in Montenegro,Montenegro,Albania,1657,1506,0,1,-16,16,1641,1522,54,81,-3,3,51,84,20,100,251
202,May 25 2010,Friendly in Austria,Nigeria,Saudi Arabia,1706,1689,0,0,0,0,1706,1689,37,42,1,0,38,42,20,0,17
203,May 25 2010,Friendly in Ukraine,Ukraine,Lithuania,1783,1585,4,0,6,-6,1789,1579,18,67,1,-1,19,66,20,100,298
204,May 25 2010,Friendly in the United States,United States,Czechia,1782,1731,2,4,-21,21,1761,1752,29,25,-4,4,25,29,20,100,151
205,May 26 2010,Friendly in Austria,Azerbaijan,Moldova,1444,1449,1,1,0,0,1444,1449,100,97,0,0,100,97,20,0,-5
206,May 26 2010,Friendly in Chile,Chile,Zambia,1870,1562,3,0,3,-3,1873,1559,11,75,0,-1,11,74,20,100,408
207,May 26 2010,Friendly in Estonia,Estonia,Croatia,1463,1901,0,0,7,-7,1470,1894,89,8,1,0,90,8,20,100,-338
208,May 26 2010,Friendly in France,France,Costa Rica,1880,1700,2,1,3,-3,1883,1697,10,41,0,0,10,41,20,100,280
209,May 26 2010,Friendly in Germany,Netherlands,Mexico,2034,1891,2,1,6,-6,2040,1885,3,9,0,0,3,9,20,0,143
210,May 26 2010,Friendly in the United States,Turkey,Northern Ireland,1802,1568,2,0,6,-6,1808,1562,17,76,0,-4,17,72,20,0,234
211,May 26 2010,Friendly tournament in Uruguay,Uruguay,Israel,1831,1738,4,1,13,-13,1844,1725,14,37,1,-2,15,35,20,0,93
212,May 27 2010,Friendly in Austria,Belarus,Honduras,1588,1744,2,2,4,-4,1592,1740,62,32,0,0,62,32,20,0,-156
213,May 27 2010,Friendly in Denmark,Denmark,Senegal,1798,1568,2,0,4,-4,1802,1564,18,74,0,-3,18,71,20,100,330
214,May 27 2010,Friendly in South Africa,South Africa,Colombia,1560,1760,2,1,13,-13,1573,1747,61,36,6,-5,67,31,20,100,-100
215,May 28 2010,Friendly in Ireland,Ireland,Algeria,1770,1540,3,0,5,-5,1775,1535,22,82,1,-1,23,81,20,100,330
216,May 29 2010,Friendly in Austria,Cameroon,Slovakia,1706,1654,1,1,-1,1,1705,1655,40,48,-1,0,39,48,20,0,52
217,May 29 2010,Friendly in Hungary,Hungary,Germany,1615,1948,0,3,-7,7,1608,1955,57,4,-2,1,55,5,20,100,-233
218,May 29 2010,Friendly in Iceland,Iceland,Andorra,1465,1026,4,0,2,-2,1467,1024,91,184,0,0,91,184,20,100,539
219,May 29 2010,Friendly in Austria,Macedonia,Azerbaijan,1586,1444,3,1,9,-9,1595,1435,54,110,5,-5,59,105,20,0,142
220,May 29 2010,Friendly in Austria,New Zealand,Serbia,1524,1860,1,0,17,-17,1541,1843,77,17,3,-2,80,15,20,0,-336
221,May 29 2010,Friendly in Norway,Norway,Montenegro,1758,1641,2,1,4,-4,1762,1637,26,51,0,0,26,51,20,100,217
222,May 29 2010,Friendly in Poland,Poland,Finland,1677,1649,0,0,-4,4,1673,1653,46,48,0,1,46,49,20,100,128
223,May 29 2010,Friendly in Austria,Spain,Saudi Arabia,2106,1689,3,2,2,-2,2108,1687,0,42,1,0,1,42,20,0,417
224,May 29 2010,Friendly in Sweden,Sweden,Bosnia and Herzegovina,1785,1650,4,2,6,-6,1791,1644,20,51,0,-1,20,50,20,100,235
225,May 29 2010,Friendly in Austria,United Arab Emirates,Moldova,1435,1449,3,2,10,-10,1445,1439,93,109,6,-6,99,103,20,0,-14
226,May 29 2010,Friendly in Ukraine,Ukraine,Romania,1789,1754,3,2,6,-6,1795,1748,19,33,0,-3,19,30,20,100,135
227,May 29 2010,Friendly in the United States,United States,Turkey,1761,1808,2,1,8,-8,1769,1800,25,19,0,-1,25,18,20,100,53
228,May 29 2010,Friendly in Venezuela,Venezuela,Canada,1730,1596,1,1,-6,6,1724,1602,39,57,-3,0,36,57,20,100,234
229,May 30 2010,Friendly in Austria,Belarus,South Korea,1592,1782,1,0,15,-15,1607,1767,49,29,7,-4,56,25,20,0,-190
230,May 30 2010,Friendly in Chile,Chile,Northern Ireland,1873,1562,1,0,2,-2,1875,1560,9,73,1,0,10,73,20,100,411
231,May 30 2010,Friendly in Chile,Chile,Israel,1875,1725,3,0,7,-7,1882,1718,9,38,1,-2,10,36,20,100,250
232,May 30 2010,Friendly in England,Colombia,Nigeria,1747,1706,1,1,-1,1,1746,1707,31,38,0,0,31,38,20,0,41
233,May 30 2010,Friendly in Austria,England,Japan,1998,1705,2,1,3,-3,2001,1702,4,41,0,-1,4,40,20,0,293
234,May 30 2010,Friendly in France,Ivory Coast,Paraguay,1725,1751,2,2,1,-1,1726,1750,34,30,0,-1,34,29,20,0,-26
235,May 30 2010,Friendly in Germany,Mexico,Gambia,1885,1412,5,1,2,-2,1887,1410,9,110,0,0,9,110,20,0,473
236,May 30 2010,Friendly in Tunisia,Tunisia,France,1613,1883,1,1,5,-5,1618,1878,53,12,0,-1,53,11,20,100,-170
237,May 31 2010,Friendly in Grenada,Grenada,Martinique,1252,1374,2,2,1,-1,1253,1373,143,115,0,0,143,115,20,100,-22
238,May 31 2010,Friendly in South Africa,South Africa,Guatemala,1573,1437,5,0,8,-8,1581,1429,63,108,2,-2,65,106,20,100,236
239,Jun 1 2010,Friendly in South Africa,Australia,Denmark,1781,1802,1,0,11,-11,1792,1791,17,23,2,-3,19,20,20,0,-21
240,Jun 1 2010,Friendly in the Netherlands,Netherlands,Ghana,2040,1683,4,1,2,-2,2042,1681,3,43,0,0,3,43,20,100,457
241,Jun 1 2010,Friendly in Portugal,Portugal,Cameroon,1868,1705,3,1,5,-5,1873,1700,12,43,0,-2,12,41,20,100,263
242,Jun 1 2010,Friendly in Switzerland,Switzerland,Costa Rica,1774,1697,0,1,-15,15,1759,1712,29,35,-3,3,26,38,20,100,177
243,Jun 2 2010,Friendly in Albania,Albania,Andorra,1522,1024,1,0,1,-1,1523,1023,84,184,0,0,84,184,20,0,498
244,Jun 2 2010,Friendly in Austria,Azerbaijan,Honduras,1435,1740,0,0,7,-7,1442,1733,100,32,2,0,102,32,20,0,-305
245,Jun 2 2010,Friendly in Belarus,Belarus,Sweden,1607,1791,0,1,-8,8,1599,1799,62,18,-3,1,59,19,20,100,-84
246,Jun 2 2010,Friendly in Austria,Macedonia,Romania,1595,1748,1,0,14,-14,1609,1734,48,32,6,-1,54,31,20,0,-153
247,Jun 2 2010,Friendly in Norway,Norway,Ukraine,1762,1795,0,1,-12,12,1750,1807,31,16,-3,1,28,17,20,100,67
248,Jun 2 2010,Friendly in Switzerland,Paraguay,Greece,1750,1751,2,0,15,-15,1765,1736,21,32,4,-2,25,30,20,0,-1
249,Jun 2 2010,Friendly in Austria,Poland,Serbia,1673,1843,0,0,5,-5,1678,1838,46,15,0,0,46,15,20,0,-170
250,Jun 2 2010,Friendly in Zimbabwe,Zimbabwe,Brazil,1335,2108,0,3,-1,1,1334,2109,121,1,0,0,121,1,20,100,-673
251,Jun 3 2010,Friendly in Germany,Germany,Bosnia and Herzegovina,1955,1644,3,1,3,-3,1958,1641,5,50,0,0,5,50,20,100,411
252,Jun 3 2010,Friendly in Belgium,Mexico,Italy,1887,1951,2,1,12,-12,1899,1939,7,6,1,0,8,6,20,0,-64
253,Jun 3 2010,Friendly in Austria,Spain,South Korea,2108,1767,1,0,2,-2,2110,1765,0,24,1,0,1,24,20,0,341
254,Jun 4 2010,Friendly in Réunion,China,France,1622,1878,1,0,16,-16,1638,1862,50,13,1,-1,51,12,20,0,-256
255,Jun 4 2010,Friendly in Switzerland,Ivory Coast,Japan,1726,1702,2,0,14,-14,1740,1688,26,42,4,-1,30,41,20,0,24
256,Jun 4 2010,Friendly in Luxembourg,Luxembourg,Faroe Islands,1097,1208,0,0,0,0,1097,1208,176,154,0,0,176,154,20,100,-11
257,Jun 4 2010,Friendly in Slovenia,Slovenia,New Zealand,1681,1541,3,1,6,-6,1687,1535,41,82,1,-1,42,81,20,100,240
258,Jun 4 2010,Friendly in Sudan,Sudan,Palestine,1334,1178,1,1,-6,6,1328,1184,127,154,-3,3,124,157,20,100,256
259,Jun 5 2010,Friendly in Germany,Algeria,United Arab Emirates,1535,1445,1,0,7,-7,1542,1438,79,109,1,-5,80,104,20,0,90
260,Jun 5 2010,Friendly in England,Ghana,Latvia,1681,1563,1,0,7,-7,1688,1556,38,80,3,-4,41,76,20,0,118
261,Jun 5 2010,Friendly in the Netherlands,Netherlands,Hungary,2042,1608,6,1,2,-2,2044,1606,3,58,0,-1,3,57,20,100,534
262,Jun 5 2010,Friendly in Austria,Romania,Honduras,1734,1733,3,0,17,-17,1751,1716,24,41,4,-4,28,37,20,0,1
263,Jun 5 2010,Friendly in Serbia,Serbia,Cameroon,1838,1700,4,3,4,-4,1842,1696,15,40,0,0,15,40,20,100,238
264,Jun 5 2010,Friendly in Slovakia,Slovakia,Costa Rica,1655,1712,3,0,15,-15,1670,1697,46,40,1,-1,47,39,20,100,43
265,Jun 5 2010,Friendly in South Africa,South Africa,Denmark,1581,1791,1,0,13,-13,1594,1778,61,21,2,0,63,21,20,100,-110
266,Jun 5 2010,Friendly in Switzerland,Switzerland,Italy,1759,1939,1,1,2,-2,1761,1937,26,6,0,0,26,6,20,100,-80
267,Jun 5 2010,Friendly in South Africa,United States,Australia,1769,1792,3,1,16,-16,1785,1776,17,24,3,-2,20,22,20,0,-23
268,Jun 6 2010,Friendly in South Africa,Nigeria,North Korea,1707,1547,3,1,9,-9,1716,1538,36,81,1,-1,37,80,20,0,160
269,Jun 7 2010,Friendly in Tanzania,Tanzania,Brazil,1334,2109,1,5,-1,1,1333,2110,125,0,-2,1,123,1,20,100,-675
270,Jun 8 2010,Friendly in South Africa,Portugal,Mozambique,1873,1376,3,0,2,-2,1875,1374,11,114,0,0,11,114,20,0,497
271,Jun 8 2010,Friendly in Spain,Spain,Poland,2110,1678,6,0,2,-2,2112,1676,1,46,0,0,1,46,20,100,532
272,Jun 9 2010,Friendly in South Africa,Chile,New Zealand,1882,1535,2,0,4,-4,1886,1531,10,82,0,0,10,82,20,0,347
273,Jun 10 2010,Friendly in South Africa,Japan,Zimbabwe,1688,1334,0,0,-8,8,1680,1342,47,121,-3,0,44,121,20,0,354
274,Jun 11 2010,World Cup in South Africa,France,Uruguay,1862,1844,0,0,-2,2,1860,1846,12,14,0,0,12,14,60,0,18
275,Jun 11 2010,World Cup in South Africa,South Africa,Mexico,1594,1899,1,1,16,-16,1610,1883,45,12,9,-2,54,10,60,100,-205
276,Jun 12 2010,World Cup in South Africa,Argentina,Nigeria,1920,1716,1,0,14,-14,1934,1702,7,37,0,0,7,37,60,0,204
277,Jun 12 2010,World Cup in South Africa,England,United States,2001,1785,1,1,-17,17,1984,1802,4,18,0,1,4,19,60,0,216
278,Jun 12 2010,World Cup in South Africa,South Korea,Greece,1765,1736,2,0,41,-41,1806,1695,12,48,6,-8,18,40,60,0,29
279,Jun 13 2010,World Cup in South Africa,Germany,Australia,1958,1776,4,0,29,-29,1987,1747,3,35,1,-6,4,29,60,0,182
280,Jun 13 2010,World Cup in South Africa,Ghana,Serbia,1688,1842,1,0,42,-42,1730,1800,23,23,9,-4,32,19,60,0,-154
281,Jun 13 2010,World Cup in South Africa,Slovenia,Algeria,1687,1542,1,0,18,-18,1705,1524,34,87,4,-4,38,83,60,0,145
282,Jun 14 2010,World Cup in South Africa,Italy,Paraguay,1937,1765,1,1,-14,14,1923,1779,8,20,-1,2,7,22,60,0,172
283,Jun 14 2010,World Cup in South Africa,Japan,Cameroon,1680,1696,1,0,31,-31,1711,1665,32,55,6,-7,38,48,60,0,-16
284,Jun 14 2010,World Cup in South Africa,Netherlands,Denmark,2044,1778,2,0,16,-16,2060,1762,3,26,0,-2,3,24,60,0,266
285,Jun 15 2010,World Cup in South Africa,Brazil,North Korea,2110,1538,2,1,2,-2,2112,1536,0,83,1,-2,1,81,50,0,572
286,Jun 15 2010,World Cup in South Africa,Ivory Coast,Portugal,1740,1875,0,0,11,-11,1751,1864,23,11,4,0,27,11,60,0,-135
287,Jun 15 2010,World Cup in South Africa,New Zealand,Slovakia,1531,1670,1,1,11,-11,1542,1659,77,50,2,-2,79,48,60,0,-139
288,Jun 16 2010,World Cup in South Africa,Chile,Honduras,1886,1716,1,0,16,-16,1902,1700,7,43,1,-3,8,40,60,0,170
289,Jun 16 2010,World Cup in South Africa,South Africa,Uruguay,1610,1846,0,3,-33,33,1577,1879,80,8,-13,3,67,11,60,100,-136
290,Jun 16 2010,World Cup in South Africa,Switzerland,Spain,1761,2112,1,0,53,-53,1814,2059,7,5,9,-2,16,3,60,0,-351
291,Jun 17 2010,World Cup in South Africa,Argentina,South Korea,1934,1806,4,1,34,-34,1968,1772,6,30,0,-6,6,24,60,0,128
292,Jun 17 2010,World Cup in South Africa,Greece,Nigeria,1695,1702,2,1,31,-31,1726,1671,26,51,8,-6,34,45,60,0,-7
293,Jun 17 2010,World Cup in South Africa,Mexico,France,1883,1860,2,0,42,-42,1925,1818,4,17,3,-2,7,15,60,0,23
294,Jun 18 2010,World Cup in South Africa,Algeria,England,1524,1984,0,0,26,-26,1550,1958,75,5,4,0,79,5,60,0,-460
295,Jun 18 2010,Baltic Cup in Lithuania,Lithuania,Latvia,1579,1556,0,0,-5,5,1574,1561,68,68,-1,4,67,72,30,100,123
296,Jun 18 2010,World Cup in South Africa,Serbia,Germany,1800,1987,1,0,45,-45,1845,1942,9,8,5,-2,14,6,60,0,-187
297,Jun 18 2010,World Cup in South Africa,Slovenia,United States,1705,1802,2,2,8,-8,1713,1794,37,24,1,-3,38,21,60,0,-97
298,Jun 19 2010,World Cup in South Africa,Australia,Ghana,1747,1730,1,1,-1,1,1746,1731,30,32,0,0,30,32,30,0,17
299,Jun 19 2010,World Cup in South Africa,Denmark,Cameroon,1762,1665,2,1,22,-22,1784,1643,19,51,3,-2,22,49,60,0,97
300,Jun 19 2010,Baltic Cup in Lithuania,Estonia,Latvia,1470,1561,0,0,4,-4,1474,1557,90,80,0,-4,90,76,30,0,-91
301,Jun 19 2010,World Cup in South Africa,Netherlands,Japan,2060,1711,1,0,7,-7,2067,1704,2,39,0,0,2,39,60,0,349
302,Jun 19 2010,Friendly in Niger,Niger,Chad,1261,1255,1,1,-3,3,1258,1258,141,138,-1,2,140,140,20,100,106
303,Jun 19 2010,Marianas Cup in the Northern Marianas,Northern Mariana Islands,Guam,499,600,1,1,0,0,499,600,229,221,0,0,229,221,20,100,-1
304,Jun 20 2010,World Cup in South Africa,Brazil,Ivory Coast,2112,1751,3,1,10,-10,2122,1741,1,35,0,-4,1,31,60,0,361
305,Jun 20 2010,World Cup in South Africa,Italy,New Zealand,1923,1542,1,1,-24,24,1899,1566,10,60,-1,10,9,70,60,0,381
306,Jun 20 2010,Baltic Cup in Lithuania,Lithuania,Estonia,1574,1474,2,0,11,-11,1585,1463,63,92,2,-1,65,91,20,0,100
307,Jun 20 2010,World Cup in South Africa,Paraguay,Slovakia,1779,1659,2,0,30,-30,1809,1629,13,57,5,-5,18,52,60,0,120
308,Jun 20 2010,Friendly in Sudan,Sudan,Tunisia,1328,1618,2,6,-9,9,1319,1627,128,53,-2,0,126,53,20,100,-190
309,Jun 21 2010,World Cup in South Africa,Chile,Switzerland,1902,1814,1,0,23,-23,1925,1791,6,27,1,-5,7,22,60,0,88
310,Jun 21 2010,World Cup in South Africa,Portugal,North Korea,1864,1536,7,0,18,-18,1882,1518,10,90,1,-4,11,86,60,0,328
311,Jun 21 2010,World Cup in South Africa,Spain,Honduras,2059,1700,2,0,10,-10,2069,1690,1,42,1,-1,2,41,60,0,359
312,Jun 22 2010,World Cup in South Africa,Argentina,Greece,1968,1726,2,0,18,-18,1986,1708,4,42,0,-4,4,38,60,0,242
313,Jun 22 2010,World Cup in South Africa,Nigeria,South Korea,1671,1772,2,2,8,-8,1679,1764,43,25,1,0,44,25,60,0,-101
314,Jun 22 2010,World Cup in South Africa,South Africa,France,1577,1818,2,1,42,-42,1619,1776,41,30,13,-7,54,23,60,100,-141
315,Jun 22 2010,World Cup in South Africa,Uruguay,Mexico,1879,1925,1,0,34,-34,1913,1891,4,15,4,-4,8,11,60,0,-46
316,Jun 23 2010,World Cup in South Africa,Australia,Serbia,1746,1845,2,1,38,-38,1784,1807,15,18,7,-2,22,16,60,0,-99
317,Jun 23 2010,World Cup in South Africa,England,Slovenia,1958,1713,1,0,12,-12,1970,1701,5,41,0,-2,5,39,60,0,245
318,Jun 23 2010,World Cup in South Africa,Germany,Ghana,1942,1731,1,0,14,-14,1956,1717,6,38,0,-3,6,35,60,0,211
319,Jun 23 2010,World Cup in South Africa,United States,Algeria,1794,1550,1,0,12,-12,1806,1538,16,80,2,0,18,80,60,0,244
320,Jun 24 2010,World Cup in South Africa,Japan,Denmark,1704,1784,3,1,55,-55,1759,1729,14,42,12,-10,26,32,60,0,-80
321,Jun 24 2010,World Cup in South Africa,Netherlands,Cameroon,2067,1643,2,1,5,-5,2072,1638,1,52,1,-2,2,50,60,0,424
322,Jun 24 2010,World Cup in South Africa,New Zealand,Paraguay,1566,1809,0,0,18,-18,1584,1791,64,25,3,-5,67,20,60,0,-243
323,Jun 24 2010,World Cup in South Africa,Slovakia,Italy,1629,1899,3,2,50,-50,1679,1849,36,15,8,-3,44,12,60,0,-270
324,Jun 25 2010,World Cup in South Africa,Brazil,Portugal,2122,1882,0,0,-18,18,2104,1900,1,7,0,2,1,9,60,0,240
325,Jun 25 2010,World Cup in South Africa,Honduras,Switzerland,1690,1791,0,0,8,-8,1698,1783,39,24,1,-2,40,22,60,0,-101
326,Jun 25 2010,World Cup in South Africa,Ivory Coast,North Korea,1741,1518,3,0,23,-23,1764,1495,19,90,6,-2,25,88,60,0,223
327,Jun 25 2010,World Cup in South Africa,Spain,Chile,2069,1925,2,1,18,-18,2087,1907,1,9,1,-1,2,8,60,0,144
328,Jun 26 2010,Friendly in China,China,Tajikistan,1638,1274,4,0,2,-2,1640,1272,50,136,0,0,50,136,20,100,464
329,Jun 26 2010,World Cup in South Africa,Ghana,United States,1717,1806,2,1,38,-38,1755,1768,18,31,9,-7,27,24,60,0,-89
330,Jun 26 2010,World Cup in South Africa,Uruguay,South Korea,1913,1764,2,1,18,-18,1931,1746,7,37,0,-6,7,31,60,0,149
331,Jun 27 2010,World Cup in South Africa,Argentina,Mexico,1986,1891,3,1,33,-33,2019,1858,4,11,0,0,4,11,60,0,95
332,Jun 27 2010,World Cup in South Africa,Germany,England,1956,1970,4,1,55,-55,2011,1915,4,9,1,-2,5,7,60,0,-14
333,Jun 28 2010,World Cup in South Africa,Brazil,Chile,2104,1907,3,0,26,-26,2130,1881,1,12,0,-2,1,10,60,0,197
334,Jun 28 2010,World Cup in South Africa,Netherlands,Slovakia,2072,1679,2,1,6,-6,2078,1673,3,48,0,-2,3,46,60,0,393
335,Jun 29 2010,World Cup in South Africa,Japan,Paraguay,1759,1791,0,0,3,-3,1762,1788,26,19,0,0,26,19,60,0,-32
336,Jun 29 2010,World Cup in South Africa,Spain,Portugal,2087,1900,1,0,15,-15,2102,1885,2,10,0,-1,2,9,60,0,187
337,Jul 1 2010,African Nations Cup qualifier in Chad,Chad,Togo,1258,1444,2,2,5,-5,1263,1439,138,105,1,-3,139,102,20,0,-186
338,Jul 1 2010,African Nations Cup qualifier in Tunisia,Tunisia,Botswana,1627,1311,0,1,-37,37,1590,1348,75,111,-11,9,64,120,40,100,416
339,Jul 2 2010,World Cup in South Africa,Ghana,Uruguay,1755,1931,1,1,14,-14,1769,1917,21,6,3,0,24,6,60,0,-176
340,Jul 2 2010,World Cup in South Africa,Netherlands,Brazil,2078,2130,2,1,34,-34,2112,2096,-1,5,2,-2,1,3,60,0,-52
341,Jul 3 2010,World Cup in South Africa,Germany,Argentina,2011,2019,4,0,58,-58,2069,1961,3,6,1,-1,4,5,60,0,-8
342,Jul 3 2010,World Cup in South Africa,Spain,Paraguay,2102,1788,1,0,8,-8,2110,1780,2,23,0,-2,2,21,60,0,314
343,Jul 3 2010,Friendly in Saint Martin,Saint Martin,Saint Barthélemy,935,700,3,0,4,-4,939,696,191,217,0,0,191,217,20,100,335
344,Jul 6 2010,World Cup in South Africa,Netherlands,Uruguay,2112,1917,3,2,15,-15,2127,1902,1,8,0,-1,1,7,60,0,195
345,Jul 7 2010,World Cup in South Africa,Spain,Germany,2110,2069,1,0,26,-26,2136,2043,0,4,1,0,1,4,60,0,41
346,Jul 9 2010,African Nations Cup qualifier in Botswana,Botswana,Chad,1348,1263,1,0,10,-10,1358,1253,118,145,1,-3,119,142,40,100,185
347,Jul 9 2010,African Nations Cup qualifier in Togo,Togo,Malawi,1439,1362,1,1,-9,9,1430,1371,108,118,-3,0,105,118,40,100,177
348,Jul 10 2010,World Cup in South Africa,Germany,Uruguay,2043,1902,3,2,18,-18,2061,1884,4,11,0,-2,4,9,60,0,141
349,Jul 11 2010,World Cup in South Africa,Spain,Netherlands,2136,2127,1,0,29,-29,2165,2098,1,2,0,0,1,2,60,0,9
350,Jul 21 2010,Friendly in Trinidad and Tobago,Trinidad and Tobago,Antigua and Barbuda,1538,1240,4,1,3,-3,1541,1237,80,149,0,-2,80,147,20,100,398
351,Aug 4 2010,Friendly in Botswana,Botswana,Zimbabwe,1358,1342,2,0,10,-10,1368,1332,119,126,0,-2,119,124,20,100,116
352,Aug 8 2010,Friendly in Anguilla,Anguilla,Saint Martin,547,939,1,3,-5,5,542,944,228,191,0,0,228,191,20,100,-292
353,Aug 10 2010,Friendly in Bosnia and Herzegovina,Bosnia and Herzegovina,Qatar,1641,1520,1,1,-6,6,1635,1526,55,82,-3,1,52,83,20,100,221
354,Aug 10 2010,Friendly in England,Ivory Coast,Italy,1764,1849,1,0,12,-12,1776,1837,18,14,4,-1,22,13,20,0,-85
355,Aug 10 2010,Friendly in the United States,United States,Brazil,1768,2096,0,2,-6,6,1762,2102,27,1,-1,1,26,2,20,100,-228
356,Aug 11 2010,Friendly in Albania,Albania,Uzbekistan,1523,1498,1,0,7,-7,1530,1491,78,91,3,-2,81,89,20,100,125
357,Aug 11 2010,Friendly in Algeria,Algeria,Gabon,1538,1580,1,2,-12,12,1526,1592,83,56,-1,6,82,62,20,100,58
358,Aug 11 2010,Friendly in Armenia,Armenia,Iran,1390,1670,1,3,-8,8,1382,1678,112,39,0,4,112,43,20,100,-180
359,Aug 11 2010,Friendly in Austria,Austria,Switzerland,1596,1783,0,1,-8,8,1588,1791,66,18,-3,1,63,19,20,100,-87
360,Aug 11 2010,Friendly in Azerbaijan,Azerbaijan,Kuwait,1442,1519,1,1,-1,1,1441,1520,102,85,-1,0,101,85,20,100,23
361,Aug 11 2010,Friendly in Benin,Benin,Niger,1423,1258,0,0,-6,6,1417,1264,107,138,0,1,107,139,20,100,265
362,Aug 11 2010,Friendly in Bolivia,Bolivia,Colombia,1595,1746,1,1,1,-1,1596,1745,59,31,1,0,60,31,20,100,-51
363,Aug 11 2010,Friendly in France,Burkina Faso,Congo,1460,1417,3,0,15,-15,1475,1402,90,111,1,-1,91,110,20,0,43
364,Aug 11 2010,African Nations Cup qualifier in Chad,Chad,Tunisia,1253,1590,1,3,-12,12,1241,1602,146,50,-2,7,144,57,40,100,-237
365,Aug 11 2010,Friendly in China,China,Bahrain,1640,1530,1,1,-5,5,1635,1535,53,76,-2,3,51,79,20,100,210
366,Aug 11 2010,Friendly in Cyprus,Cyprus,Andorra,1558,1023,1,0,1,-1,1559,1022,73,186,1,-1,74,185,20,0,535
367,Aug 11 2010,Friendly in Czechia,Czechia,Latvia,1752,1557,4,1,5,-5,1757,1552,30,75,-1,1,29,76,20,100,295
368,Aug 11 2010,Friendly in Denmark,Denmark,Germany,1729,2061,2,2,6,-6,1735,2055,33,4,0,0,33,4,20,100,-232
369,Aug 11 2010,Friendly in Egypt,Egypt,DR Congo,1833,1419,6,3,2,-2,1835,1417,14,106,0,1,14,107,20,100,514
370,Aug 11 2010,Friendly in England,England,Hungary,1915,1606,2,1,2,-2,1917,1604,6,55,0,1,6,56,20,100,409
371,Aug 11 2010,European Championship qual in Estonia,Estonia,Faroe Islands,1463,1208,2,1,5,-5,1468,1203,93,156,-1,-1,92,155,40,100,355
372,Aug 11 2010,Friendly in Finland,Finland,Belgium,1653,1594,1,0,6,-6,1659,1588,48,63,0,0,48,63,20,100,159
373,Aug 11 2010,Friendly in France,Guinea,Mali,1460,1551,2,0,19,-19,1479,1532,88,81,2,-1,90,80,20,0,-91
374,Aug 11 2010,Friendly in Iceland,Iceland,Liechtenstein,1467,1158,1,1,-8,8,1459,1166,96,157,-3,6,93,163,20,100,409
375,Aug 11 2010,Friendly in Ireland,Ireland,Argentina,1775,1961,0,1,-8,8,1767,1969,24,5,0,0,24,5,20,100,-86
376,Aug 11 2010,Friendly in Kazakhstan,Kazakhstan,Oman,1334,1609,3,1,22,-22,1356,1587,118,76,2,-11,120,65,20,100,-175
377,Aug 11 2010,Friendly in Lithuania,Lithuania,Belarus,1585,1599,0,2,-19,19,1566,1618,78,51,-6,4,72,55,20,100,86
378,Aug 11 2010,African Nations Cup qualifier in Malawi,Malawi,Botswana,1371,1368,1,1,-6,6,1365,1374,120,111,-1,4,119,115,40,100,103
379,Aug 11 2010,Friendly in Malta,Malta,Macedonia,1216,1609,1,1,7,-7,1223,1602,149,60,1,-3,150,57,20,100,-293
380,Aug 11 2010,Friendly in Mauritania,Mauritania,Palestine,1149,1184,0,0,-2,2,1147,1186,171,157,0,0,171,157,20,100,65
381,Aug 11 2010,Friendly in Mexico,Mexico,Spain,1858,2165,1,1,5,-5,1863,2160,11,1,0,0,11,1,20,100,-207
382,Aug 11 2010,Friendly in Moldova,Moldova,Georgia,1439,1449,0,0,-3,3,1436,1452,104,95,-1,1,103,96,20,100,90
383,Aug 11 2010,Friendly in Montenegro,Montenegro,Northern Ireland,1637,1560,2,0,8,-8,1645,1552,49,79,1,-3,50,76,20,100,177
384,Aug 11 2010,Friendly in Morocco,Morocco,Equatorial Guinea,1569,1211,2,1,1,-1,1570,1210,69,152,0,0,69,152,20,100,458
385,Aug 11 2010,Friendly in Mozambique,Mozambique,Swaziland,1374,1169,2,1,3,-3,1377,1166,114,163,0,0,114,163,20,100,305
386,Aug 11 2010,Friendly in Norway,Norway,France,1750,1776,2,1,8,-8,1758,1768,24,24,3,-1,27,23,20,100,74
387,Aug 11 2010,Friendly in Panama,Panama,Venezuela,1566,1724,3,1,17,-17,1583,1707,65,43,3,-4,68,39,20,100,-58
388,Aug 11 2010,Friendly in Paraguay,Paraguay,Costa Rica,1780,1697,2,0,8,-8,1788,1689,19,41,1,0,20,41,20,100,183
389,Aug 11 2010,Friendly in Poland,Poland,Cameroon,1676,1638,0,3,-24,24,1652,1662,53,44,-4,3,49,47,20,100,138
390,Aug 11 2010,Friendly in Russia,Russia,Bulgaria,1848,1729,1,0,4,-4,1852,1725,12,35,0,-1,12,34,20,100,219
391,Aug 11 2010,Friendly in Saudi Arabia,Saudi Arabia,Togo,1687,1430,1,0,2,-2,1689,1428,40,107,1,-1,41,106,20,100,357
392,Aug 11 2010,Friendly in Senegal,Senegal,Cape Verde,1564,1373,1,0,3,-3,1567,1370,70,121,1,-3,71,118,20,100,291
393,Aug 11 2010,Friendly in Serbia,Serbia,Greece,1807,1708,0,1,-15,15,1792,1723,21,32,-3,3,18,35,20,100,199
394,Aug 11 2010,Friendly in Slovakia,Slovakia,Croatia,1673,1894,1,1,3,-3,1676,1891,42,7,2,0,44,7,20,100,-121
395,Aug 11 2010,Friendly in Slovenia,Slovenia,Australia,1701,1784,2,0,14,-14,1715,1770,37,25,1,-3,38,22,20,100,17
396,Aug 11 2010,Friendly in South Africa,South Africa,Ghana,1619,1769,1,0,11,-11,1630,1758,53,29,0,-2,53,27,20,100,-50
397,Aug 11 2010,Friendly in South Korea,South Korea,Nigeria,1746,1679,2,1,6,-6,1752,1673,29,46,1,-1,30,45,20,100,167
398,Aug 11 2010,Friendly in Sweden,Sweden,Scotland,1799,1680,3,0,8,-8,1807,1672,16,49,1,-3,17,46,20,100,219
399,Aug 11 2010,Friendly in Tanzania,Tanzania,Kenya,1333,1318,1,1,-3,3,1330,1321,125,126,-1,1,124,127,20,100,115
400,Aug 11 2010,Friendly in Thailand,Thailand,Singapore,1443,1351,1,0,5,-5,1448,1346,99,122,0,-1,99,121,20,100,192
401,Aug 11 2010,Friendly in Trinidad and Tobago,Trinidad and Tobago,Jamaica,1541,1607,1,3,-16,16,1525,1623,88,52,-4,2,84,54,20,100,34
402,Aug 11 2010,Friendly in Turkey,Turkey,Romania,1800,1751,2,0,9,-9,1809,1742,15,35,1,-3,16,32,20,100,149
403,Aug 11 2010,Friendly in Uganda,Uganda,Zambia,1555,1559,1,1,-3,3,1552,1562,74,72,2,1,76,73,20,100,96
404,Aug 11 2010,Friendly in Ukraine,Ukraine,Netherlands,1807,2098,1,1,5,-5,1812,2093,15,3,0,0,15,3,20,100,-191
405,Aug 11 2010,Friendly in Portugal,Uruguay,Angola,1884,1451,2,0,2,-2,1886,1449,7,98,1,-1,8,97,20,0,433
406,Aug 11 2010,Friendly in Wales,Wales,Luxembourg,1595,1097,5,1,1,-1,1596,1096,59,176,1,0,60,176,20,100,598
407,Aug 18 2010,Friendly in Ethiopia,Ethiopia,Kenya,1300,1321,0,3,-21,21,1279,1342,137,119,-2,4,135,123,20,100,79
408,Aug 20 2010,Friendly in Madagascar,Madagascar,Mayotte,1270,1126,0,0,-6,6,1264,1132,139,172,-1,1,138,173,20,100,244
409,Aug 26 2010,Friendly in Saint Lucia,Saint Lucia,Martinique,1129,1373,1,3,-9,9,1120,1382,176,108,-1,4,175,112,20,100,-144
410,Aug 28 2010,Friendly in Saint Kitts and Nevis,Saint Kitts and Nevis,Antigua and Barbuda,1164,1237,1,1,-1,1,1163,1238,171,147,-3,0,168,147,20,100,27
411,Aug 28 2010,Friendly in Saint Lucia,Saint Lucia,Martinique,1120,1382,1,1,4,-4,1124,1378,175,116,0,-2,175,114,20,100,-162
412,Aug 29 2010,Friendly in Ethiopia,Ethiopia,Chad,1279,1241,1,0,6,-6,1285,1235,135,150,0,-3,135,147,20,100,138
413,Aug 29 2010,Friendly in Madagascar,Madagascar,Comoros,1264,867,1,0,1,-1,1265,866,136,204,1,0,137,204,20,100,497
414,Sep 2 2010,European Championship qual in Israel,Israel,Malta,1718,1223,3,1,2,-2,1720,1221,36,152,0,-1,36,151,20,0,495
415,Sep 3 2010,African Nations Cup qualifier in Algeria,Algeria,Tanzania,1526,1330,1,1,-14,14,1512,1344,88,121,-3,2,85,123,40,100,296
416,Sep 3 2010,European Championship qual in Andorra,Andorra,Russia,1022,1852,0,2,-1,1,1021,1853,185,12,0,0,185,12,30,100,-730
417,Sep 3 2010,European Championship qual in Armenia,Armenia,Ireland,1382,1767,0,1,-6,6,1376,1773,118,20,-3,2,115,22,40,100,-285
418,Sep 3 2010,European Championship qual in Belgium,Belgium,Germany,1588,2055,0,1,-4,4,1584,2059,69,4,-3,0,66,4,40,100,-367
419,Sep 3 2010,Friendly in China,China,Iran,1635,1678,0,2,-17,17,1618,1695,59,35,-4,4,55,39,20,100,57
420,Sep 3 2010,European Championship qual in England,England,Bulgaria,1917,1725,4,0,12,-12,1929,1713,6,38,0,-2,6,36,40,100,292
421,Sep 3 2010,European Championship qual in Estonia,Estonia,Italy,1468,1837,1,2,-7,7,1461,1844,96,13,-2,0,94,13,40,100,-269
422,Sep 3 2010,European Championship qual in the Faroe Islands,Faroe Islands,Serbia,1203,1792,0,3,-4,4,1199,1796,155,18,0,0,155,18,40,100,-489
423,Sep 3 2010,European Championship qual in France,France,Belarus,1768,1618,0,1,-32,32,1736,1650,39,45,-8,5,31,50,40,100,250
424,Sep 3 2010,European Championship qual in Greece,Greece,Georgia,1723,1452,1,1,-16,16,1707,1468,39,90,-2,3,37,93,40,100,371
425,Sep 3 2010,European Championship qual in Iceland,Iceland,Norway,1459,1758,1,2,-10,10,1449,1768,101,21,-4,3,97,24,40,100,-199
426,Sep 3 2010,European Championship qual in Kazakhstan,Kazakhstan,Turkey,1356,1809,0,3,-8,8,1348,1817,120,14,0,1,120,15,40,100,-353
427,Sep 3 2010,Friendly in Kuwait,Kuwait,Syria,1520,1568,3,0,15,-15,1535,1553,77,82,4,-6,81,76,20,100,52
428,Sep 3 2010,European Championship qual in Latvia,Latvia,Croatia,1552,1891,0,3,-14,14,1538,1905,82,7,-3,0,79,7,40,100,-239
429,Sep 3 2010,European Championship qual in Liechtenstein,Liechtenstein,Spain,1166,2160,0,4,0,0,1166,2160,163,1,0,0,163,1,20,0,-994
430,Sep 3 2010,European Championship qual in Lithuania,Lithuania,Scotland,1566,1672,0,0,0,0,1566,1672,74,46,-1,0,73,46,20,100,-6
431,Sep 3 2010,European Championship qual in Luxembourg,Luxembourg,Bosnia and Herzegovina,1096,1635,0,3,-5,5,1091,1640,178,51,-1,0,177,51,40,100,-439
432,Sep 3 2010,European Championship qual in Moldova,Moldova,Finland,1436,1659,2,0,40,-40,1476,1619,79,60,12,-6,91,54,40,100,-123
433,Sep 3 2010,European Championship qual in Montenegro,Montenegro,Wales,1645,1596,1,0,12,-12,1657,1584,46,72,2,-6,48,66,40,100,149
434,Sep 3 2010,Friendly in Qatar,Oman,Malaysia,1587,1179,3,0,3,-3,1590,1176,59,161,3,-1,62,160,20,0,408
435,Sep 3 2010,Friendly in Panama,Panama,Costa Rica,1583,1689,2,2,0,0,1583,1689,70,39,-1,1,69,40,20,100,-6
436,Sep 3 2010,European Championship qual in Portugal,Portugal,Cyprus,1885,1559,4,4,-17,17,1868,1576,11,66,-1,4,10,70,40,100,426
437,Sep 3 2010,Friendly in Qatar,Qatar,Bahrain,1526,1535,1,1,-3,3,1523,1538,86,79,-2,0,84,79,20,100,91
438,Sep 3 2010,European Championship qual in Romania,Romania,Albania,1742,1530,1,1,-14,14,1728,1544,34,75,-1,3,33,78,40,100,312
439,Sep 3 2010,European Championship qual in San Marino,San Marino,Netherlands,912,2093,0,5,0,0,912,2093,197,3,0,0,197,3,20,0,-1181
440,Sep 3 2010,European Championship qual in Slovakia,Slovakia,Macedonia,1676,1602,1,0,11,-11,1687,1591,42,65,1,-4,43,61,40,100,174
441,Sep 3 2010,European Championship qual in Slovenia,Slovenia,Northern Ireland,1715,1552,0,1,-33,33,1682,1585,50,54,-6,11,44,65,40,100,263
442,Sep 3 2010,European Championship qual in Sweden,Sweden,Hungary,1807,1604,2,0,9,-9,1816,1595,15,62,1,-3,16,59,40,100,303
443,Sep 3 2010,Friendly in Switzerland,Switzerland,Australia,1791,1770,0,0,-3,3,1788,1773,19,22,0,0,19,22,20,100,121
444,Sep 3 2010,Friendly in Venezuela,Venezuela,Colombia,1707,1745,0,2,-18,18,1689,1763,41,19,-1,6,40,25,20,100,62
445,Sep 4 2010,African Nations Cup qualifier in Botswana,Botswana,Togo,1374,1428,2,1,17,-17,1391,1411,108,112,4,-3,112,109,30,0,-54
446,Sep 4 2010,Friendly in Canada,Canada,Peru,1602,1587,0,2,-20,20,1582,1607,82,48,-13,8,69,56,20,100,115
447,Sep 4 2010,African Nations Cup qualifier in Cape Verde,Cape Verde,Mali,1370,1532,1,0,24,-24,1394,1508,104,90,7,-4,111,86,40,100,-62
448,Sep 4 2010,Friendly tournament in the United States,El Salvador,Honduras,1501,1698,2,2,8,-8,1509,1690,84,40,1,-1,85,39,30,0,-197
449,Sep 4 2010,African Nations Cup qualifier in The Gambia,Gambia,Namibia,1410,1324,3,1,15,-15,1425,1309,103,138,3,-6,106,132,40,100,186
450,Sep 4 2010,Friendly in the United States,Guatemala,Nicaragua,1429,1080,5,0,5,-5,1434,1075,101,179,2,0,103,179,20,0,349
451,Sep 4 2010,African Nations Cup qualifier in Guinea-Bissau,Guinea-Bissau,Kenya,1246,1342,1,0,20,-20,1266,1322,131,130,6,-3,137,127,40,100,4
452,Sep 4 2010,African Nations Cup qualifier in Ivory Coast,Ivory Coast,Rwanda,1776,1402,3,0,4,-4,1780,1398,19,110,1,0,20,110,20,0,374
453,Sep 4 2010,Friendly in Japan,Japan,Paraguay,1762,1788,1,0,8,-8,1770,1780,22,21,2,-1,24,20,20,100,74
454,Sep 4 2010,African Nations Cup qualifier in Mauritius,Mauritius,Cameroon,1035,1662,1,3,-3,3,1032,1665,183,47,0,0,183,47,40,100,-527
455,Sep 4 2010,Friendly in Mexico,Mexico,Ecuador,1863,1717,1,2,-16,16,1847,1733,13,31,-1,2,12,33,20,100,246
456,Sep 4 2010,African Nations Cup qualifier in Morocco,Morocco,Central African Republic,1570,1182,0,0,-18,18,1552,1200,83,152,-6,3,77,155,40,100,488
457,Sep 4 2010,Friendly in Poland,Poland,Ukraine,1652,1812,1,1,2,-2,1654,1810,49,17,0,0,49,17,20,100,-60
458,Sep 4 2010,African Nations Cup qualifier in South Africa,South Africa,Niger,1630,1264,2,0,4,-4,1634,1260,52,143,0,-2,52,141,40,100,466
459,Sep 4 2010,African Nations Cup qualifier in Sudan,Sudan,Congo,1319,1402,2,0,29,-29,1348,1373,112,126,8,-8,120,118,40,100,17
460,Sep 4 2010,Friendly in Thailand,Thailand,India,1448,1174,1,0,2,-2,1450,1172,94,162,3,0,97,162,20,100,374
461,Sep 4 2010,African Nations Cup qualifier in Tunisia,Tunisia,Malawi,1602,1365,2,2,-15,15,1587,1380,70,107,-7,6,63,113,40,100,337
462,Sep 4 2010,African Nations Cup qualifier in Uganda,Uganda,Angola,1552,1449,3,0,17,-17,1569,1432,65,111,6,-7,71,104,40,100,203
463,Sep 5 2010,African Nations Cup qualifier in Benin,Benin,Burundi,1417,1191,1,1,-15,15,1402,1206,109,151,-1,3,108,154,40,100,326
464,Sep 5 2010,Friendly in France,Burkina Faso,Gabon,1475,1592,1,1,3,-3,1478,1589,90,65,1,-3,91,62,20,0,-117
465,Sep 5 2010,African Nations Cup qualifier in the Dem Rep of the Congo,DR Congo,Senegal,1417,1567,2,4,-26,26,1391,1593,115,46,-4,13,111,59,40,100,-50
466,Sep 5 2010,African Nations Cup qualifier in Egypt,Egypt,Sierra Leone,1835,1265,1,1,-19,19,1816,1284,16,132,-1,3,15,135,40,0,570
467,Sep 5 2010,African Nations Cup qualifier in Ethiopia,Ethiopia,Guinea,1285,1479,1,4,-26,26,1259,1505,147,84,-6,3,141,87,40,100,-94
468,Sep 5 2010,Friendly in Jamaica,Jamaica,Costa Rica,1623,1689,1,0,9,-9,1632,1680,53,48,0,-4,53,44,20,100,34
469,Sep 5 2010,African Nations Cup qualifier in Liberia,Liberia,Zimbabwe,1239,1332,1,1,0,0,1239,1332,144,125,0,0,144,125,20,100,7
470,Sep 5 2010,African Nations Cup qualifier in Mozambique,Mozambique,Libya,1377,1494,0,0,1,-1,1378,1493,114,90,1,-1,115,89,30,100,-17
471,Sep 5 2010,African Nations Cup qualifier in Nigeria,Nigeria,Madagascar,1673,1265,2,0,3,-3,1676,1262,45,138,0,0,45,138,20,0,408
472,Sep 5 2010,African Nations Cup qualifier in Swaziland,Swaziland,Ghana,1166,1758,0,3,-4,4,1162,1762,173,26,-5,1,168,27,40,100,-492
473,Sep 5 2010,African Nations Cup qualifier in Zambia,Zambia,Comoros,1562,866,4,0,1,-1,1563,865,74,204,0,0,74,204,20,0,696
474,Sep 7 2010,European Championship qual in Albania,Albania,Luxembourg,1544,1091,1,0,2,-2,1546,1089,78,177,0,0,78,177,30,0,453
475,Sep 7 2010,Friendly in Argentina,Argentina,Spain,1969,2160,4,1,22,-22,1991,2138,5,1,0,0,5,1,20,100,-91
476,Sep 7 2010,European Championship qual in Austria,Austria,Kazakhstan,1588,1348,2,0,7,-7,1595,1341,57,128,3,-4,60,124,40,100,340
477,Sep 7 2010,European Championship qual in Belarus,Belarus,Romania,1650,1728,0,0,-1,1,1649,1729,48,30,1,2,49,32,20,100,22
478,Sep 7 2010,European Championship qual in Bosnia and Herzegovina,Bosnia and Herzegovina,France,1640,1736,0,2,-30,30,1610,1766,61,19,-5,6,56,25,40,100,4
479,Sep 7 2010,European Championship qual in Bulgaria,Bulgaria,Montenegro,1713,1657,0,1,-28,28,1685,1685,48,36,-6,6,42,42,40,100,156
480,Sep 7 2010,Friendly in Canada,Canada,Honduras,1582,1690,2,1,10,-10,1592,1680,56,49,7,-5,63,44,20,100,-8
481,Sep 7 2010,Friendly in China,China,Paraguay,1618,1780,1,1,2,-2,1620,1778,51,24,2,-2,53,22,20,100,-62
482,Sep 7 2010,European Championship qual in Croatia,Croatia,Greece,1905,1707,0,0,-14,14,1891,1721,7,33,0,2,7,35,40,100,298
483,Sep 7 2010,European Championship qual in Czechia,Czechia,Lithuania,1757,1566,0,1,-34,34,1723,1600,39,43,-5,15,34,58,40,100,291
484,Sep 7 2010,European Championship qual in Denmark,Denmark,Iceland,1735,1449,1,0,4,-4,1739,1445,28,104,2,-3,30,101,40,100,386
485,Sep 7 2010,Friendly in Estonia,Estonia,Uzbekistan,1461,1491,3,3,-2,2,1459,1493,94,86,0,2,94,88,20,100,70
486,Sep 7 2010,European Championship qual in Georgia,Georgia,Israel,1468,1720,0,0,8,-8,1476,1712,91,39,1,-2,92,37,40,100,-152
487,Sep 7 2010,European Championship qual in Germany,Germany,Azerbaijan,2059,1441,6,1,1,-1,2060,1440,4,105,0,-2,4,103,20,0,618
488,Sep 7 2010,Friendly in the United States,Guatemala,El Salvador,1434,1509,2,0,18,-18,1452,1491,93,95,5,-5,98,90,20,0,-75
489,Sep 7 2010,European Championship qual in Hungary,Hungary,Moldova,1595,1476,2,1,9,-9,1604,1467,56,94,1,-1,57,93,40,100,219
490,Sep 7 2010,European Championship qual in Ireland,Ireland,Andorra,1773,1021,3,1,0,0,1773,1021,24,185,-1,0,23,185,20,0,752
491,Sep 7 2010,European Championship qual in Italy,Italy,Faroe Islands,1844,1199,5,0,1,-1,1845,1198,11,157,1,0,12,157,20,0,645
492,Sep 7 2010,Friendly in Japan,Japan,Guatemala,1770,1452,2,1,2,-2,1772,1450,24,93,0,5,24,98,20,100,418
493,Sep 7 2010,European Championship qual in Macedonia,Macedonia,Armenia,1591,1376,2,2,-14,14,1577,1390,82,109,-11,4,71,113,40,100,315
494,Sep 7 2010,European Championship qual in Malta,Malta,Latvia,1221,1538,0,2,-13,13,1208,1551,155,75,-2,2,153,77,40,100,-217
495,Sep 7 2010,Friendly in Mexico,Mexico,Colombia,1847,1763,1,0,5,-5,1852,1758,8,32,2,-3,10,29,20,100,184
496,Sep 7 2010,European Championship qual in the Netherlands,Netherlands,Finland,2093,1619,2,1,1,-1,2094,1618,3,54,0,0,3,54,20,0,474
497,Sep 7 2010,European Championship qual in Norway,Norway,Portugal,1768,1868,1,0,20,-20,1788,1848,11,12,7,-1,18,11,40,100,0
498,Sep 7 2010,Friendly in Panama,Panama,Trinidad and Tobago,1583,1525,3,0,10,-10,1593,1515,53,84,8,-1,61,83,20,100,158
499,Sep 7 2010,Friendly in the United States,Peru,Jamaica,1607,1632,2,1,11,-11,1618,1621,52,51,2,1,54,52,20,0,-25
500,Sep 7 2010,Friendly in Poland,Poland,Australia,1654,1773,1,2,-9,9,1645,1782,51,18,-1,2,50,20,20,100,-19
501,Sep 7 2010,Friendly in Qatar,Qatar,Oman,1523,1590,1,1,-1,1,1522,1591,79,67,2,-3,81,64,20,100,33
502,Sep 7 2010,European Championship qual in Russia,Russia,Slovakia,1853,1687,0,1,-33,33,1820,1720,17,30,-3,6,14,36,40,100,266
503,Sep 7 2010,European Championship qual in Scotland,Scotland,Liechtenstein,1672,1166,2,1,1,-1,1673,1165,48,163,-1,0,47,163,20,0,506
504,Sep 7 2010,European Championship qual in Serbia,Serbia,Slovenia,1796,1682,1,1,-11,11,1785,1693,20,37,-1,3,19,40,40,100,214
505,Sep 7 2010,Friendly in South Korea,South Korea,Iran,1752,1695,0,1,-14,14,1738,1709,32,38,-1,0,31,38,20,100,157
506,Sep 7 2010,European Championship qual in Sweden,Sweden,San Marino,1816,912,6,0,0,0,1816,912,17,197,-1,0,16,197,20,0,904
507,Sep 7 2010,European Championship qual in Switzerland,Switzerland,England,1788,1929,1,3,-26,26,1762,1955,33,6,-7,0,26,6,40,100,-41
508,Sep 7 2010,European Championship qual in Turkey,Turkey,Belgium,1817,1584,3,2,5,-5,1822,1579,12,74,1,-4,13,70,40,100,333
509,Sep 7 2010,Friendly in the United Arab Emirates,United Arab Emirates,Kuwait,1438,1535,3,0,17,-17,1455,1518,88,83,7,-1,95,82,20,100,3
510,Sep 7 2010,Friendly in Ukraine,Ukraine,Chile,1810,1881,2,1,9,-9,1819,1872,13,9,2,0,15,9,20,100,29
511,Sep 7 2010,Friendly in Venezuela,Venezuela,Ecuador,1689,1733,1,0,8,-8,1697,1725,38,33,1,0,39,33,20,100,56
512,Sep 7 2010,Friendly in Yemen,Yemen,Syria,1290,1553,2,1,14,-14,1304,1539,133,82,0,-3,133,79,20,100,-163
513,Sep 8 2010,Friendly in India,India,Thailand,1172,1450,1,2,-5,5,1167,1455,162,92,0,3,162,95,20,100,-178
514,Sep 10 2010,Friendly in Belize,Belize,Trinidad and Tobago,1084,1515,0,0,7,-7,1091,1508,176,85,1,-1,177,84,20,100,-331
515,Sep 10 2010,Friendly in Saint Lucia,Saint Lucia,St Vincent & Grenadines,1124,1235,1,5,-18,18,1106,1253,175,139,0,4,175,143,20,100,-11
516,Sep 11 2010,Friendly in French Guiana,French Guiana,Suriname,1210,1239,1,2,-12,12,1198,1251,161,145,-5,0,156,145,20,100,71
517,Sep 15 2010,Friendly in India,India,Namibia,1167,1309,2,0,17,-17,1184,1292,156,134,3,-1,159,133,20,100,-42
518,Sep 16 2010,Friendly in Jordan,Jordan,Iraq,1455,1558,4,1,18,-18,1473,1540,91,81,2,-3,93,78,20,100,-3
519,Sep 17 2010,Friendly in St Vincent & Grenadines,St Vincent & Grenadines,Grenada,1253,1253,0,1,-13,13,1240,1266,147,131,-2,6,145,137,20,100,100
520,Sep 18 2010,Friendly in Saint Martin,British Virgin Islands,Anguilla,887,542,2,1,2,-2,889,540,199,228,1,0,200,228,20,0,345
521,Sep 18 2010,Friendly in Yemen,Yemen,Zambia,1304,1563,0,1,-6,6,1298,1569,132,72,0,1,132,73,20,100,-159
522,Sep 19 2010,Friendly tournament in Antigua and Barbuda,Antigua and Barbuda,Trinidad and Tobago,1238,1508,0,1,-8,8,1230,1516,149,82,-1,1,148,83,30,100,-170
523,Sep 19 2010,Friendly in Jordan,Jordan,Bahrain,1473,1538,2,0,13,-13,1486,1525,89,80,2,0,91,80,20,100,35
524,Sep 19 2010,Friendly in Saint Martin,Saint Martin,British Virgin Islands,944,889,3,1,9,-9,953,880,191,202,0,-1,191,201,20,100,155
525,Sep 19 2010,Friendly in St Vincent & Grenadines,St Vincent & Grenadines,Grenada,1240,1266,0,0,-2,2,1238,1268,147,137,-1,0,146,137,20,100,74
526,Sep 21 2010,Friendly in Jordan,Iraq,Oman,1540,1591,3,2,11,-11,1551,1580,74,74,2,-5,76,69,20,0,-51
527,Sep 21 2010,Friendly tournament in Antigua and Barbuda,Trinidad and Tobago,Saint Lucia,1516,1106,3,0,5,-5,1521,1101,81,175,1,0,82,175,30,0,410
528,Sep 22 2010,French Territory Cup in France,French Guiana,Mayotte,1198,1132,2,2,-3,3,1195,1135,158,173,-1,0,157,173,30,0,66
529,Sep 22 2010,French Territory Cup in France,Réunion,Saint Pierre and Miquelon,1317,700,11,0,2,-2,1319,698,128,216,0,0,128,216,20,0,617
530,Sep 23 2010,Friendly tournament in Antigua and Barbuda,Antigua and Barbuda,Saint Lucia,1230,1101,5,0,13,-13,1243,1088,142,181,3,-3,145,178,20,0,129
531,Sep 23 2010,French Territory Cup in France,Guadeloupe,New Caledonia,1442,1311,1,1,-5,5,1437,1316,104,129,-1,0,103,129,30,0,131
532,Sep 23 2010,French Territory Cup in France,Martinique,Tahiti,1378,1175,4,1,12,-12,1390,1163,110,170,3,-4,113,166,30,0,203
533,Sep 24 2010,West Asian Championship in Jordan,Iran,Bahrain,1709,1525,3,0,18,-18,1727,1507,28,90,5,-5,33,85,40,0,184
534,Sep 24 2010,West Asian Championship in Jordan,Jordan,Syria,1486,1539,1,1,-3,3,1483,1542,91,79,0,0,91,79,40,100,47
535,Sep 24 2010,Friendly tournament in Vietnam,Vietnam,North Korea,1345,1495,0,0,2,-2,1347,1493,120,87,1,0,121,87,30,100,-50
536,Sep 25 2010,Friendly in Barbados,Barbados,Dominica,1311,993,0,2,-28,28,1283,1021,140,184,-5,1,135,185,20,100,418
537,Sep 25 2010,French Territory Cup in France,French Guiana,Saint Pierre and Miquelon,1195,698,7,0,4,-4,1199,694,155,220,1,-2,156,218,30,0,497
538,Sep 25 2010,West Asian Championship in Jordan,Iraq,Yemen,1551,1298,2,1,8,-8,1559,1290,74,132,1,0,75,132,40,0,253
539,Sep 25 2010,French Territory Cup in France,Réunion,Mayotte,1319,1135,2,1,8,-8,1327,1127,124,173,2,0,126,173,30,0,184
540,Sep 26 2010,West Asian Championship in Jordan,Bahrain,Oman,1507,1580,2,0,36,-36,1543,1544,73,87,6,-9,79,78,40,0,-73
541,Sep 26 2010,Friendly in Barbados,Barbados,Dominica,1283,1021,1,3,-27,27,1256,1048,151,177,-8,4,143,181,20,100,362
542,Sep 26 2010,French Territory Cup in France,Guadeloupe,Tahiti,1437,1163,1,1,-10,10,1427,1173,107,158,-2,4,105,162,30,0,274
543,Sep 26 2010,Friendly in Guyana,Guyana,Trinidad and Tobago,1261,1521,1,1,4,-4,1265,1517,136,85,2,-2,138,83,20,100,-160
544,Sep 26 2010,West Asian Championship in Jordan,Kuwait,Syria,1518,1542,2,1,21,-21,1539,1521,78,85,2,-3,80,82,40,0,-24
545,Sep 26 2010,French Territory Cup in France,Martinique,New Caledonia,1390,1316,4,0,22,-22,1412,1294,101,131,6,-1,107,130,30,0,74
546,Sep 27 2010,West Asian Championship in Jordan,Yemen,Palestine,1290,1186,3,1,21,-21,1311,1165,126,166,3,-4,129,162,40,0,104
547,Sep 28 2010,West Asian Championship in Jordan,Iran,Oman,1727,1544,2,2,-10,10,1717,1554,41,72,-4,3,37,75,30,100,283
548,Sep 28 2010,West Asian Championship in Jordan,Jordan,Kuwait,1483,1539,2,2,-3,3,1480,1542,91,80,0,0,91,80,40,100,44
549,Sep 28 2010,French Territory Cup in France,Mayotte,Saint Pierre and Miquelon,1127,694,10,0,6,-6,1133,688,173,220,0,-1,173,219,30,0,433
550,Sep 28 2010,French Territory Cup in France,Réunion,French Guiana,1327,1199,1,0,10,-10,1337,1189,124,158,1,-1,125,157,30,0,128
551,Sep 29 2010,French Territory Cup in France,Guadeloupe,Martinique,1427,1412,2,0,22,-22,1449,1390,95,119,5,-6,100,113,30,0,15
552,Sep 29 2010,West Asian Championship in Jordan,Iraq,Palestine,1559,1165,3,0,7,-7,1566,1158,74,176,0,-7,74,169,40,0,394
553,Sep 29 2010,French Territory Cup in France,New Caledonia,Tahiti,1294,1173,1,1,-5,5,1289,1178,133,159,-1,1,132,160,30,0,121
554,Oct 1 2010,French Territory Cup in France,Guadeloupe,Mayotte,1449,1133,4,0,8,-8,1457,1125,92,175,4,-1,96,174,30,0,316
555,Oct 1 2010,West Asian Championship in Jordan,Iran,Iraq,1717,1566,2,1,12,-12,1729,1554,27,74,5,0,32,74,40,0,151
556,Oct 1 2010,West Asian Championship in Jordan,Kuwait,Yemen,1542,1311,1,1,-12,12,1530,1323,80,125,0,2,80,127,40,0,231
557,Oct 2 2010,CONCACAF Ch & Car Ch q in Puerto Rico,Cayman Islands,Saint Martin,977,953,1,1,-1,1,976,954,189,191,-1,0,188,191,20,0,24
558,Oct 2 2010,French Territory Cup in France,Martinique,Réunion,1390,1337,0,0,-2,2,1388,1339,115,125,-1,0,114,125,20,0,53
559,Oct 2 2010,CONCACAF Ch & Car Ch q in Puerto Rico,Puerto Rico,Anguilla,974,540,3,1,3,-3,977,537,186,229,1,0,187,229,30,0,434
560,Oct 3 2010,West Asian Championship in Jordan,Kuwait,Iran,1530,1729,2,1,30,-30,1560,1699,68,44,6,-6,74,38,40,0,-199
561,Oct 4 2010,CONCACAF Ch & Car Ch q in Puerto Rico,Cayman Islands,Anguilla,976,537,4,1,5,-5,981,532,188,229,0,0,188,229,40,0,439
562,Oct 4 2010,Friendly in India,India,Hong Kong,1184,1205,0,1,-12,12,1172,1217,164,148,-3,3,161,151,20,100,79
563,Oct 4 2010,CONCACAF Ch & Car Ch q in Puerto Rico,Puerto Rico,Saint Martin,977,954,2,0,20,-20,997,934,187,191,0,0,187,191,40,100,123
564,Oct 6 2010,CONCACAF Ch & Car Ch q in Puerto Rico,Anguilla,Saint Martin,532,934,2,1,36,-36,568,898,225,205,2,-7,227,198,40,0,-402
565,Oct 6 2010,CONCACAF Ch & Car Ch q in St Vincent & Grenadines,Barbados,Saint Kitts and Nevis,1256,1163,1,1,-5,5,1251,1168,143,158,0,4,143,162,20,100,193
566,Oct 6 2010,CONCACAF Ch & Car Ch q in Puerto Rico,Puerto Rico,Cayman Islands,997,981,2,0,20,-20,1017,961,187,190,0,-1,187,189,40,100,116
567,Oct 6 2010,CONCACAF Ch & Car Ch q in St Vincent & Grenadines,St Vincent & Grenadines,Montserrat,1238,521,7,0,1,-1,1239,520,145,230,1,0,146,230,20,0,717
568,Oct 7 2010,Friendly in Bolivia,Bolivia,Venezuela,1596,1697,1,3,-15,15,1581,1712,77,35,-9,2,68,37,20,100,-1
569,Oct 7 2010,Friendly in the United Arab Emirates,Brazil,Iran,2102,1699,3,0,3,-3,2105,1696,2,40,0,-1,2,39,20,0,403
570,Oct 8 2010,European Championship qual in Albania,Albania,Bosnia and Herzegovina,1546,1610,1,1,-2,2,1544,1612,77,56,1,0,78,56,30,100,36
571,Oct 8 2010,European Championship qual in Andorra,Andorra,Macedonia,1021,1577,0,2,-4,4,1017,1581,186,64,0,3,186,67,40,100,-456
572,Oct 8 2010,European Championship qual in Armenia,Armenia,Slovakia,1390,1720,3,1,47,-47,1437,1673,93,54,10,-9,103,45,40,100,-230
573,Oct 8 2010,European Championship qual in Austria,Austria,Azerbaijan,1595,1440,3,0,13,-13,1608,1427,55,109,2,-3,57,106,40,100,255
574,Oct 8 2010,CONCACAF Ch & Car Ch q in St Vincent & Grenadines,Barbados,Montserrat,1251,520,5,0,1,-1,1252,519,143,230,0,0,143,230,20,0,731
575,Oct 8 2010,Friendly in China,China,Syria,1620,1521,2,1,5,-5,1625,1516,53,84,0,-1,53,83,20,100,199
576,Oct 8 2010,Friendly in the United States,Colombia,Ecuador,1758,1725,1,0,9,-9,1767,1716,17,37,6,-2,23,35,20,0,33
577,Oct 8 2010,European Championship qual in Cyprus,Cyprus,Norway,1576,1788,1,2,-14,14,1562,1802,77,18,-3,0,74,18,40,100,-112
578,Oct 8 2010,European Championship qual in Czechia,Czechia,Scotland,1723,1673,1,0,12,-12,1735,1661,26,49,4,-1,30,48,40,100,150
579,Oct 8 2010,European Championship qual in Georgia,Georgia,Malta,1476,1208,1,0,4,-4,1480,1204,91,155,1,-1,92,154,20,0,268
580,Oct 8 2010,European Championship qual in Germany,Germany,Turkey,2060,1822,3,0,9,-9,2069,1813,4,19,0,-3,4,16,40,100,338
581,Oct 8 2010,European Championship qual in Greece,Greece,Latvia,1721,1551,1,0,7,-7,1728,1544,31,78,2,0,33,78,40,100,270
582,Oct 8 2010,European Championship qual in Hungary,Hungary,San Marino,1604,912,8,0,1,-1,1605,911,59,196,-1,0,58,196,20,0,692
583,Oct 8 2010,Friendly in India,India,Vietnam,1172,1347,3,1,18,-18,1190,1329,153,129,4,-4,157,125,20,100,-75
584,Oct 8 2010,Friendly in Indonesia,Indonesia,Uruguay,1258,1886,1,7,-2,2,1256,1888,142,8,0,0,142,8,20,100,-528
585,Oct 8 2010,European Championship qual in Ireland,Ireland,Russia,1773,1820,2,3,-23,23,1750,1843,31,10,-4,2,27,12,40,100,53
586,Oct 8 2010,Friendly in Japan,Japan,Argentina,1772,1991,1,0,13,-13,1785,1978,14,5,5,0,19,5,20,100,-119
587,Oct 8 2010,European Championship qual in Kazakhstan,Kazakhstan,Belgium,1341,1579,0,2,-19,19,1322,1598,132,53,-4,8,128,61,40,100,-138
588,Oct 8 2010,Friendly in Kuwait,Kuwait,Bahrain,1560,1543,1,3,-20,20,1540,1563,86,66,-6,7,80,73,20,100,117
589,Oct 8 2010,European Championship qual in Luxembourg,Luxembourg,Belarus,1089,1649,0,0,17,-17,1106,1632,173,53,2,-2,175,51,40,100,-460
590,Oct 8 2010,European Championship qual in Moldova,Moldova,Netherlands,1467,2094,0,1,-2,2,1465,2096,96,3,-1,0,95,3,40,100,-527
591,Oct 8 2010,European Championship qual in Montenegro,Montenegro,Switzerland,1685,1762,1,0,19,-19,1704,1743,36,30,3,-2,39,28,40,100,23
592,Oct 8 2010,European Championship qual in Northern Ireland,Northern Ireland,Italy,1585,1845,0,0,9,-9,1594,1836,61,14,2,-1,63,13,40,100,-160
593,Oct 8 2010,Friendly in Oman,Oman,Gabon,1554,1589,1,0,8,-8,1562,1581,73,71,1,-4,74,67,20,100,65
594,Oct 8 2010,Friendly in Panama,Panama,El Salvador,1593,1491,1,0,5,-5,1598,1486,62,92,-1,-1,61,91,20,100,202
595,Oct 8 2010,Friendly in Peru,Peru,Costa Rica,1618,1680,2,0,13,-13,1631,1667,50,48,2,-2,52,46,20,100,38
596,Oct 8 2010,European Championship qual in Portugal,Portugal,Denmark,1848,1739,3,1,14,-14,1862,1725,9,38,1,-4,10,34,40,100,209
597,Oct 8 2010,European Championship qual in Serbia,Serbia,Estonia,1785,1459,1,3,-55,55,1730,1514,43,73,-12,11,31,84,40,100,426
598,Oct 8 2010,European Championship qual in Slovenia,Slovenia,Faroe Islands,1693,1198,5,1,2,-2,1695,1196,42,156,-1,0,41,156,20,0,495
599,Oct 8 2010,European Championship qual in Spain,Spain,Lithuania,2138,1600,3,1,1,-1,2139,1599,1,60,0,-1,1,59,20,0,538
600,Oct 8 2010,CONCACAF Ch & Car Ch q in St Vincent & Grenadines,St Vincent & Grenadines,Saint Kitts and Nevis,1239,1168,1,1,-9,9,1230,1177,150,160,-2,1,148,161,40,100,171
601,Oct 8 2010,Friendly in Ukraine,Ukraine,Canada,1819,1592,2,2,-7,7,1812,1599,19,56,-2,3,17,59,20,100,327
602,Oct 8 2010,European Championship qual in Wales,Wales,Bulgaria,1584,1685,0,1,-20,20,1564,1705,78,34,-6,4,72,38,40,100,-1
603,Oct 9 2010,African Nations Cup qualifier in Angola,Angola,Guinea-Bissau,1432,1266,1,0,7,-7,1439,1259,104,143,0,-3,104,140,40,100,266
604,Oct 9 2010,Friendly in Australia,Australia,Paraguay,1782,1778,1,0,7,-7,1789,1771,18,24,1,-1,19,23,20,100,104
605,Oct 9 2010,African Nations Cup qualifier in Burkina Faso,Burkina Faso,Gambia,1478,1425,3,1,18,-18,1496,1407,82,111,6,-2,88,109,40,100,153
606,Oct 9 2010,African Nations Cup qualifier in Burundi,Burundi,Ivory Coast,1206,1780,0,1,-2,2,1204,1782,153,23,0,-1,153,22,30,100,-474
607,Oct 9 2010,African Nations Cup qualifier in Cameroon,Cameroon,DR Congo,1665,1391,1,1,-16,16,1649,1407,51,106,-2,3,49,109,40,100,374
608,Oct 9 2010,African Nations Cup qualifier in the Comoros,Comoros,Mozambique,865,1378,0,1,-3,3,862,1381,204,113,0,2,204,115,30,100,-413
609,Oct 9 2010,European Championship qual in France,France,Romania,1766,1729,2,0,19,-19,1785,1710,16,40,4,-4,20,36,40,100,137
610,Oct 9 2010,Friendly in Guatemala,Guatemala,Belize,1450,1091,4,2,2,-2,1452,1089,98,177,1,0,99,177,20,100,459
611,Oct 9 2010,European Championship qual in Israel,Israel,Croatia,1712,1891,1,2,-16,16,1696,1907,42,7,-3,0,39,7,40,100,-79
612,Oct 9 2010,African Nations Cup qualifier in Kenya,Kenya,Uganda,1322,1569,0,0,8,-8,1330,1561,120,82,4,-6,124,76,40,100,-147
613,Oct 9 2010,African Nations Cup qualifier in Malawi,Malawi,Chad,1380,1235,6,2,15,-15,1395,1220,107,153,4,-3,111,150,40,100,245
614,Oct 9 2010,African Nations Cup qualifier in Mali,Mali,Liberia,1508,1239,2,1,4,-4,1512,1235,84,146,1,0,85,146,20,0,269
615,Oct 9 2010,Friendly in New Zealand,New Zealand,Honduras,1584,1680,1,1,0,0,1584,1680,66,43,0,0,66,43,20,100,4
616,Oct 9 2010,African Nations Cup qualifier in Rwanda,Rwanda,Benin,1398,1402,0,3,-44,44,1354,1446,128,95,-9,7,119,102,40,100,96
617,Oct 9 2010,Friendly in Saudi Arabia,Saudi Arabia,Uzbekistan,1689,1493,4,0,6,-6,1695,1487,40,94,1,-3,41,91,20,100,296
618,Oct 9 2010,African Nations Cup qualifier in Senegal,Senegal,Mauritius,1593,1032,7,0,2,-2,1595,1030,62,184,1,0,63,184,20,0,561
619,Oct 9 2010,Friendly tournament in Taiwan,Taiwan,Macao,923,698,7,1,9,-9,932,689,187,220,4,-2,191,218,20,0,225
620,Oct 9 2010,African Nations Cup qualifier in Tanzania,Tanzania,Morocco,1344,1552,0,1,-14,14,1330,1566,126,65,-2,6,124,71,40,100,-108
621,Oct 9 2010,Friendly in the United Arab Emirates,United Arab Emirates,Chile,1455,1872,0,2,-4,4,1451,1876,103,9,-3,0,100,9,20,100,-317
622,Oct 9 2010,Friendly in the United States,United States,Poland,1762,1645,2,2,-6,6,1756,1651,27,47,-1,1,26,48,20,100,217
623,Oct 10 2010,African Nations Cup qualifier in Central African Republic,Central African Republic,Algeria,1200,1512,2,0,46,-46,1246,1466,133,103,11,-9,144,94,40,100,-212
624,Oct 10 2010,African Nations Cup qualifier in Congo,Congo,Swaziland,1373,1162,3,1,9,-9,1382,1153,113,171,2,-2,115,169,40,100,311
625,Oct 10 2010,African Nations Cup qualifier in Ghana,Ghana,Sudan,1762,1348,0,0,-18,18,1744,1366,29,118,-2,1,27,119,40,100,514
626,Oct 10 2010,African Nations Cup qualifier in Guinea,Guinea,Nigeria,1505,1676,1,0,24,-24,1529,1652,75,50,6,-3,81,47,40,100,-71
627,Oct 10 2010,Friendly in Jamaica,Jamaica,Trinidad and Tobago,1621,1517,1,0,5,-5,1626,1512,50,88,2,-3,52,85,20,100,204
628,Oct 10 2010,African Nations Cup qualifier in Libya,Libya,Zambia,1493,1569,1,0,19,-19,1512,1550,81,84,4,-7,85,77,40,100,24
629,Oct 10 2010,African Nations Cup qualifier in Madagascar,Madagascar,Ethiopia,1262,1259,0,1,-26,26,1236,1285,154,132,-8,4,146,136,40,100,103
630,Oct 10 2010,African Nations Cup qualifier in Niger,Niger,Egypt,1260,1816,1,0,37,-37,1297,1779,123,30,8,-8,131,22,40,100,-456
631,Oct 10 2010,African Nations Cup qualifier in Sierra Leone,Sierra Leone,South Africa,1284,1634,0,0,12,-12,1296,1622,130,58,2,-4,132,54,40,100,-250
632,Oct 10 2010,CONCACAF Ch & Car Ch q in St Vincent & Grenadines,Saint Kitts and Nevis,Montserrat,1177,519,4,0,2,-2,1179,517,157,230,2,0,159,230,40,0,658
633,Oct 10 2010,CONCACAF Ch & Car Ch q in St Vincent & Grenadines,St Vincent & Grenadines,Barbados,1230,1252,0,0,-4,4,1226,1256,151,139,-2,2,149,141,40,100,78
634,Oct 10 2010,Friendly tournament in Taiwan,Taiwan,Philippines,932,821,1,1,-8,8,924,829,199,204,-4,1,195,205,30,100,211
635,Oct 10 2010,African Nations Cup qualifier in Togo,Togo,Tunisia,1411,1587,1,2,-16,16,1395,1603,114,53,-3,6,111,59,40,100,-76
636,Oct 10 2010,African Nations Cup qualifier in Zimbabwe,Zimbabwe,Cape Verde,1332,1394,0,0,-2,2,1330,1396,123,108,0,2,123,110,30,100,38
637,Oct 11 2010,Friendly in England,Brazil,Ukraine,2105,1812,2,0,5,-5,2110,1807,2,16,0,0,2,16,20,0,293
638,Oct 12 2010,European Championship qual in Armenia,Armenia,Andorra,1437,1017,4,0,4,-4,1441,1013,103,188,1,-1,104,187,40,100,520
639,Oct 12 2010,European Championship qual in Azerbaijan,Azerbaijan,Turkey,1427,1813,1,0,34,-34,1461,1779,85,29,11,-7,96,22,40,100,-286
640,Oct 12 2010,Friendly in Bahrain,Bahrain,Uzbekistan,1563,1487,2,4,-22,22,1541,1509,84,84,-6,3,78,87,20,100,176
641,Oct 12 2010,European Championship qual in Belarus,Belarus,Albania,1632,1544,2,0,15,-15,1647,1529,50,82,0,-2,50,80,40,100,188
642,Oct 12 2010,European Championship qual in Belgium,Belgium,Austria,1598,1608,4,4,-5,5,1593,1613,64,53,-1,2,63,55,40,100,90
643,Oct 12 2010,Friendly in Turkey,Bulgaria,Saudi Arabia,1705,1695,2,0,15,-15,1720,1680,31,41,3,0,34,41,20,0,10
644,Oct 12 2010,Friendly tournament in China,China,Uruguay,1625,1888,0,4,-16,16,1609,1904,61,8,-4,0,57,8,30,100,-163
645,Oct 12 2010,Friendly in Costa Rica,Costa Rica,El Salvador,1667,1486,2,1,3,-3,1670,1483,45,93,0,-1,45,92,20,100,281
646,Oct 12 2010,Friendly in Croatia,Croatia,Norway,1907,1802,2,1,5,-5,1912,1797,7,15,0,1,7,16,20,100,205
647,Oct 12 2010,European Championship qual in Denmark,Denmark,Cyprus,1725,1562,2,0,11,-11,1736,1551,29,77,2,-2,31,75,40,100,263
648,Oct 12 2010,Friendly in Canada,Ecuador,Poland,1716,1651,2,2,-2,2,1714,1653,40,46,-3,1,37,47,20,0,65
649,Oct 12 2010,European Championship qual in England,England,Montenegro,1955,1704,0,0,-15,15,1940,1719,6,32,0,3,6,35,40,100,351
650,Oct 12 2010,Friendly in Equatorial Guinea,Equatorial Guinea,Botswana,1210,1391,0,2,-12,12,1198,1403,159,107,-3,3,156,110,20,100,-81
651,Oct 12 2010,European Championship qual in Estonia,Estonia,Slovenia,1514,1695,0,1,-15,15,1499,1710,92,35,-4,3,88,38,40,100,-81
652,Oct 12 2010,European Championship qual in the Faroe Islands,Faroe Islands,Northern Ireland,1196,1594,1,1,14,-14,1210,1580,150,67,3,-1,153,66,40,100,-298
653,Oct 12 2010,European Championship qual in Finland,Finland,Hungary,1618,1605,1,2,-26,26,1592,1631,73,44,-9,7,64,51,40,100,113
654,Oct 12 2010,European Championship qual in France,France,Luxembourg,1785,1106,2,0,1,-1,1786,1105,19,175,0,0,19,175,20,0,679
655,Oct 12 2010,European Championship qual in Greece,Greece,Israel,1728,1696,2,1,13,-13,1741,1683,26,47,3,-4,29,43,40,100,132
656,Oct 12 2010,Friendly in the United States,Honduras,Guatemala,1680,1452,2,0,6,-6,1686,1446,41,105,1,-3,42,102,20,0,228
657,Oct 12 2010,European Championship qual in Iceland,Iceland,Portugal,1445,1862,1,3,-8,8,1437,1870,107,10,-2,0,105,10,40,100,-317
658,Oct 12 2010,Friendly in Indonesia,Indonesia,Maldives,1256,1164,3,0,9,-9,1265,1155,137,172,2,-4,139,168,20,100,192
659,Oct 12 2010,European Championship qual in Kazakhstan,Kazakhstan,Germany,1322,2069,0,3,-2,2,1320,2071,129,4,0,0,129,4,40,100,-647
660,Oct 12 2010,Friendly in Kuwait,Kuwait,Vietnam,1540,1329,3,1,4,-4,1544,1325,74,126,3,0,77,126,20,100,311
661,Oct 12 2010,European Championship qual in Latvia,Latvia,Georgia,1544,1480,1,1,-9,9,1535,1489,80,90,-1,1,79,91,40,100,164
662,Oct 12 2010,European Championship qual in Liechtenstein,Liechtenstein,Czechia,1165,1735,0,2,-4,4,1161,1739,169,30,-3,0,166,30,40,100,-470
663,Oct 12 2010,European Championship qual in Macedonia,Macedonia,Russia,1581,1843,0,1,-11,11,1570,1854,71,10,-2,1,69,11,40,100,-162
664,Oct 12 2010,Friendly in Mexico,Mexico,Venezuela,1852,1712,2,2,-6,6,1846,1718,13,37,-1,-1,12,36,20,100,240
665,Oct 12 2010,European Championship qual in the Netherlands,Netherlands,Sweden,2096,1816,4,1,7,-7,2103,1809,3,14,0,0,3,14,40,100,380
666,Oct 12 2010,Friendly in New Zealand,New Zealand,Paraguay,1584,1771,0,2,-11,11,1573,1782,70,17,-2,3,68,20,20,100,-87
667,Oct 12 2010,Friendly in Oman,Oman,Chile,1562,1876,0,1,-5,5,1557,1881,73,9,0,0,73,9,20,100,-214
668,Oct 12 2010,Friendly in Panama,Panama,Peru,1598,1631,1,0,8,-8,1606,1623,54,55,4,-2,58,53,20,100,67
669,Oct 12 2010,Friendly tournament in Taiwan,Philippines,Macao,829,689,5,0,19,-19,848,670,205,222,0,-2,205,220,30,0,140
670,Oct 12 2010,Friendly in Qatar,Qatar,Iraq,1522,1554,1,2,-12,12,1510,1566,90,64,-4,6,86,70,20,100,68
671,Oct 12 2010,European Championship qual in San Marino,San Marino,Moldova,911,1465,0,2,-4,4,907,1469,196,93,0,1,196,94,40,100,-454
672,Oct 12 2010,Friendly in Turkey,Saudi Arabia,Gabon,1680,1581,1,0,7,-7,1687,1574,41,67,0,0,41,67,20,0,99
673,Oct 12 2010,European Championship qual in Scotland,Scotland,Spain,1661,2139,2,3,-4,4,1657,2143,46,1,0,0,46,1,40,100,-378
674,Oct 12 2010,European Championship qual in Slovakia,Slovakia,Ireland,1673,1750,1,1,-1,1,1672,1751,44,28,0,-1,44,27,20,100,23
675,Oct 12 2010,Friendly in South Korea,South Korea,Japan,1738,1785,0,0,-2,2,1736,1787,33,17,-2,1,31,18,20,100,53
676,Oct 12 2010,European Championship qual in Switzerland,Switzerland,Wales,1743,1564,4,1,12,-12,1755,1552,22,77,3,-3,25,74,40,100,279
677,Oct 12 2010,Friendly in the United Arab Emirates,United Arab Emirates,Angola,1451,1439,0,2,-20,20,1431,1459,112,90,-6,7,106,97,20,100,112
678,Oct 12 2010,Friendly in the United States,United States,Colombia,1756,1767,0,0,-3,3,1753,1770,27,24,-1,0,26,24,20,100,89
679,Oct 13 2010,CONCACAF Ch & Car Ch q in Suriname,Guyana,Saint Lucia,1265,1088,1,0,11,-11,1276,1077,135,178,2,0,137,178,40,0,177
680,Oct 13 2010,Friendly in India,India,Yemen,1190,1323,3,6,-16,16,1174,1339,167,117,-5,5,162,122,20,100,-33
681,Oct 13 2010,CONCACAF Ch & Car Ch q in Suriname,Suriname,Netherlands Antilles,1251,1138,2,1,9,-9,1260,1129,139,172,2,0,141,172,40,100,213
682,Oct 14 2010,CONCACAF Ch & Car Ch q in the Dominican Republic,Dominican Republic,British Virgin Islands,1044,880,17,0,25,-25,1069,855,177,207,3,-3,180,204,40,100,264
683,Oct 15 2010,CONCACAF Ch & Car Ch q in the Dominican Republic,Dominica,British Virgin Islands,1048,855,10,0,26,-26,1074,829,176,206,3,-1,179,205,40,0,193
684,Oct 15 2010,CONCACAF Ch & Car Ch q in Suriname,Guyana,Netherlands Antilles,1276,1129,3,2,12,-12,1288,1117,133,176,2,-2,135,174,40,0,147
685,Oct 15 2010,CONCACAF Ch & Car Ch q in Suriname,Suriname,Saint Lucia,1260,1077,2,1,7,-7,1267,1070,139,182,1,-2,140,180,40,100,283
686,Oct 17 2010,CONCACAF Ch & Car Ch q in the Dominican Republic,Dominican Republic,Dominica,1069,1074,0,1,-25,25,1044,1099,185,173,-2,3,183,176,40,100,95
687,Oct 17 2010,CONCACAF Ch & Car Ch q in Suriname,Netherlands Antilles,Saint Lucia,1117,1070,2,2,-3,3,1114,1073,174,180,0,0,174,180,40,0,47
688,Oct 17 2010,CONCACAF Ch & Car Ch q in Suriname,Suriname,Guyana,1267,1288,0,2,-37,37,1230,1325,154,119,-7,8,147,127,40,100,79
689,Oct 22 2010,CONCACAF Ch & Car Ch q in Grenada,Grenada,Puerto Rico,1268,1017,3,1,7,-7,1275,1010,137,188,1,-1,138,187,40,100,351
690,Oct 22 2010,CONCACAF Ch & Car Ch q in Grenada,Guadeloupe,Saint Kitts and Nevis,1457,1179,2,1,7,-7,1464,1172,94,166,2,-4,96,162,40,0,278
691,Oct 22 2010,Southeast Asian Champ qual in Laos,Laos,Cambodia,871,775,0,0,-10,10,861,785,205,209,-2,0,203,209,40,100,196
692,Oct 22 2010,Southeast Asian Champ qual in Laos,Philippines,East Timor,848,563,5,0,13,-13,861,550,202,229,1,0,203,229,40,0,285
693,Oct 24 2010,Southeast Asian Champ qual in Laos,Cambodia,East Timor,785,550,4,2,12,-12,797,538,205,229,2,0,207,229,40,0,235
694,Oct 24 2010,CONCACAF Ch & Car Ch q in Grenada,Grenada,Saint Kitts and Nevis,1275,1172,2,0,14,-14,1289,1158,132,170,3,-4,135,166,40,100,203
695,Oct 24 2010,CONCACAF Ch & Car Ch q in Grenada,Guadeloupe,Puerto Rico,1464,1010,3,2,3,-3,1467,1007,94,187,1,0,95,187,40,0,454
696,Oct 24 2010,Southeast Asian Champ qual in Laos,Laos,Philippines,861,861,2,2,-6,6,855,867,205,201,-1,1,204,202,40,100,100
697,Oct 26 2010,Southeast Asian Champ qual in Laos,Cambodia,Philippines,797,867,0,0,4,-4,801,863,207,202,0,0,207,202,40,0,-70
698,Oct 26 2010,CONCACAF Ch & Car Ch q in Grenada,Grenada,Guadeloupe,1289,1467,0,3,-27,27,1262,1494,145,85,-5,5,140,90,40,100,-78
699,Oct 26 2010,Southeast Asian Champ qual in Laos,Laos,East Timor,855,538,6,1,7,-7,862,531,202,229,1,0,203,229,40,100,417
700,Oct 26 2010,Friendly in Panama,Panama,Cuba,1606,1449,0,3,-29,29,1577,1478,74,89,-8,6,66,95,20,100,257
701,Oct 26 2010,CONCACAF Ch & Car Ch q in Grenada,Saint Kitts and Nevis,Puerto Rico,1158,1007,1,0,12,-12,1170,995,158,187,4,0,162,187,40,0,151
702,Oct 27 2010,Friendly in Botswana,Botswana,Swaziland,1403,1153,2,0,4,-4,1407,1149,106,171,2,-1,108,170,20,100,350
703,Oct 28 2010,Friendly in Yemen,Yemen,Senegal,1339,1595,4,1,25,-25,1364,1570,118,75,2,-7,120,68,20,100,-156
704,Oct 29 2010,Friendly tournament in Curaçao,Curaçao,Aruba,1114,907,3,0,8,-8,1122,899,174,198,0,-1,174,197,20,0,207
705,Oct 29 2010,Friendly tournament in Curaçao,Suriname,Bonaire,1230,1092,4,2,14,-14,1244,1078,141,179,3,-1,144,178,30,0,138
706,Oct 31 2010,Friendly tournament in Curaçao,Aruba,Bonaire,899,1078,3,3,7,-7,906,1071,197,182,0,-2,197,180,30,0,-179
707,Oct 31 2010,Friendly tournament in Curaçao,Curaçao,Suriname,1122,1244,2,2,1,-1,1123,1243,174,144,0,0,174,144,20,100,-22
708,Nov 2 2010,CONCACAF Ch & Car Ch q in Trinidad and Tobago,Guyana,Haiti,1325,1431,0,0,6,-6,1331,1425,121,108,3,-1,124,107,40,0,-106
709,Nov 2 2010,Friendly tournament in Vietnam,North Korea,Singapore,1493,1346,2,1,9,-9,1502,1337,85,124,3,-1,88,123,30,0,147
710,Nov 2 2010,CONCACAF Ch & Car Ch q in Trinidad and Tobago,Trinidad and Tobago,St Vincent & Grenadines,1512,1226,6,2,7,-7,1519,1219,81,153,1,-2,82,151,40,100,386
711,Nov 4 2010,CONCACAF Ch & Car Ch q in Trinidad and Tobago,Haiti,St Vincent & Grenadines,1425,1219,3,1,14,-14,1439,1205,103,155,2,-2,105,153,40,0,206
712,Nov 4 2010,CONCACAF Ch & Car Ch q in Trinidad and Tobago,Trinidad and Tobago,Guyana,1519,1331,2,1,6,-6,1525,1325,82,130,0,-3,82,127,40,100,288
713,Nov 4 2010,Friendly tournament in Vietnam,Vietnam,Singapore,1325,1337,1,1,-4,4,1321,1341,130,121,-1,1,129,122,30,100,88
714,Nov 6 2010,CONCACAF Ch & Car Ch q in Trinidad and Tobago,Guyana,St Vincent & Grenadines,1325,1205,2,0,20,-20,1345,1185,117,161,5,-4,122,157,40,0,120
715,Nov 6 2010,CONCACAF Ch & Car Ch q in Trinidad and Tobago,Trinidad and Tobago,Haiti,1525,1439,4,0,19,-19,1544,1420,72,109,5,-2,77,107,40,100,186
716,Nov 6 2010,Friendly tournament in Vietnam,Vietnam,North Korea,1321,1502,0,2,-17,17,1304,1519,133,78,-2,5,131,83,30,100,-81
717,Nov 7 2010,Friendly in Yemen,Yemen,Uganda,1364,1561,2,2,3,-3,1367,1558,118,72,1,0,119,72,20,100,-97
718,Nov 10 2010,CONCACAF Ch & Car Ch q in Antigua and Barbuda,Antigua and Barbuda,Suriname,1243,1243,2,1,14,-14,1257,1229,140,150,2,-3,142,147,40,100,100
719,Nov 10 2010,Friendly in Bahrain,Bahrain,Uganda,1541,1558,0,0,-2,2,1539,1560,79,72,0,0,79,72,20,100,83
720,Nov 10 2010,CONCACAF Ch & Car Ch q in Antigua and Barbuda,Cuba,Dominica,1478,1099,4,2,6,-6,1484,1093,91,176,2,0,93,176,40,0,379
721,Nov 10 2010,Friendly in Yemen,Yemen,North Korea,1367,1519,1,1,1,-1,1368,1518,119,83,0,0,119,83,20,100,-52
722,Nov 11 2010,Friendly in the United Arab Emirates,Iraq,India,1566,1174,2,0,3,-3,1569,1171,70,161,0,0,70,161,20,0,392
723,Nov 12 2010,CONCACAF Ch & Car Ch q in Antigua and Barbuda,Antigua and Barbuda,Dominica,1257,1093,0,0,-13,13,1244,1106,146,174,-2,1,144,175,40,100,264
724,Nov 12 2010,CONCACAF Ch & Car Ch q in Antigua and Barbuda,Cuba,Suriname,1484,1229,3,3,-13,13,1471,1242,97,143,-2,2,95,145,40,0,255
725,Nov 14 2010,CONCACAF Ch & Car Ch q in Antigua and Barbuda,Antigua and Barbuda,Cuba,1244,1471,0,0,7,-7,1251,1464,144,99,0,-2,144,97,40,100,-127
726,Nov 14 2010,Friendly in Bahrain,Bahrain,Syria,1539,1516,0,2,-20,20,1519,1536,87,74,-4,5,83,79,20,100,123
727,Nov 14 2010,Friendly in the United Arab Emirates,Kuwait,India,1544,1171,9,1,5,-5,1549,1166,77,163,0,-1,77,162,20,0,373
728,Nov 14 2010,CONCACAF Ch & Car Ch q in Antigua and Barbuda,Suriname,Dominica,1242,1106,5,0,25,-25,1267,1081,133,179,6,-2,139,177,40,0,136
729,Nov 16 2010,Friendly in Portugal,Cape Verde,Guinea-Bissau,1396,1259,2,1,6,-6,1402,1253,111,144,0,-1,111,143,20,0,137
730,Nov 16 2010,Friendly in Jordan,Jordan,Cyprus,1480,1551,0,0,-1,1,1479,1552,94,73,0,1,94,74,20,100,29
731,Nov 16 2010,Friendly in the United Arab Emirates,Saudi Arabia,Uganda,1687,1560,0,0,-4,4,1683,1564,43,72,-1,0,42,72,20,0,127
732,Nov 16 2010,Friendly in Scotland,Scotland,Faroe Islands,1657,1210,3,0,1,-1,1658,1209,46,152,0,0,46,152,20,100,547
733,Nov 17 2010,Friendly in Albania,Albania,Macedonia,1529,1570,0,0,-2,2,1527,1572,81,68,0,0,81,68,20,100,59
734,Nov 17 2010,Friendly in Qatar,Argentina,Brazil,1978,2110,1,0,14,-14,1992,2096,5,4,0,-1,5,3,20,0,-132
735,Nov 17 2010,Friendly in Austria,Austria,Greece,1613,1741,1,2,-9,9,1604,1750,61,25,-3,2,58,27,20,100,-28
736,Nov 17 2010,African Nations Cup qualifier in Botswana,Botswana,Tunisia,1407,1603,1,0,25,-25,1432,1578,104,72,2,-7,106,65,40,100,-96
737,Nov 17 2010,Friendly in Bulgaria,Bulgaria,Serbia,1720,1730,0,1,-13,13,1707,1743,40,23,-3,5,37,28,20,100,90
738,Nov 17 2010,Friendly in France,Burkina Faso,Guinea,1496,1529,2,1,11,-11,1507,1518,86,87,2,-3,88,84,20,0,-33
739,Nov 17 2010,Friendly in Chile,Chile,Uruguay,1881,1904,2,0,12,-12,1893,1892,9,12,0,-2,9,10,20,100,77
740,Nov 17 2010,Friendly in China,China,Latvia,1609,1535,1,0,5,-5,1614,1530,55,80,1,0,56,80,20,100,174
741,Nov 17 2010,Friendly in Colombia,Colombia,Peru,1770,1623,1,1,-6,6,1764,1629,26,51,-1,1,25,52,20,100,247
742,Nov 17 2010,Friendly in the United States,Costa Rica,Jamaica,1670,1626,0,0,-1,1,1669,1627,43,54,1,-1,44,53,20,0,44
743,Nov 17 2010,European Championship qual in Croatia,Croatia,Malta,1912,1204,3,0,1,-1,1913,1203,7,155,0,-1,7,154,20,0,708
744,Nov 17 2010,Friendly in Denmark,Denmark,Czechia,1736,1739,0,0,-3,3,1733,1742,35,28,-2,1,33,29,20,100,97
745,Nov 17 2010,Friendly in Ecuador,Ecuador,Venezuela,1714,1718,4,1,13,-13,1727,1705,31,40,3,-2,34,38,20,100,96
746,Nov 17 2010,Friendly in Egypt,Egypt,Australia,1779,1789,3,0,13,-13,1792,1776,14,27,4,-5,18,22,20,100,90
747,Nov 17 2010,Friendly in England,England,France,1940,1786,1,2,-16,16,1924,1802,6,15,0,2,6,17,20,100,254
748,Nov 17 2010,Friendly in Estonia,Estonia,Liechtenstein,1499,1161,1,1,-9,9,1490,1170,95,156,-3,5,92,161,20,100,438
749,Nov 17 2010,European Championship qual in Finland,Finland,San Marino,1592,907,8,0,1,-1,1593,906,58,196,2,0,60,196,20,0,685
750,Nov 17 2010,Friendly in the United Arab Emirates,Ghana,Saudi Arabia,1744,1683,0,0,-2,2,1742,1685,30,40,-1,1,29,41,20,0,61
751,Nov 17 2010,Friendly in the United States,Guatemala,Guyana,1446,1345,3,0,13,-13,1459,1332,94,126,4,-2,98,124,20,0,101
752,Nov 17 2010,Friendly in Hong Kong,Hong Kong,Paraguay,1217,1782,0,7,-3,3,1214,1785,151,20,0,0,151,20,20,100,-465
753,Nov 17 2010,Friendly in Hungary,Hungary,Lithuania,1631,1599,2,0,10,-10,1641,1589,51,65,0,-3,51,62,20,100,132
754,Nov 17 2010,Friendly in the United Arab Emirates,Iraq,Kuwait,1569,1549,1,1,-1,1,1568,1550,70,73,0,2,70,75,20,0,20
755,Nov 17 2010,Friendly in Ireland,Ireland,Norway,1751,1797,1,2,-12,12,1739,1809,35,14,-4,1,31,15,20,100,54
756,Nov 17 2010,Friendly in Israel,Israel,Iceland,1683,1437,3,2,2,-2,1685,1435,40,105,1,0,41,105,20,100,346
757,Nov 17 2010,Friendly in Austria,Italy,Romania,1836,1710,1,1,-3,3,1833,1713,11,34,1,2,12,36,20,0,126
758,Nov 17 2010,Friendly tournament in Libya,Libya,Niger,1512,1297,1,1,-11,11,1501,1308,95,130,-5,1,90,131,30,100,315
759,Nov 17 2010,Friendly in Luxembourg,Luxembourg,Algeria,1105,1466,0,0,6,-6,1111,1460,175,98,0,-1,175,97,20,100,-261
760,Nov 17 2010,Friendly in Malawi,Malawi,Rwanda,1395,1354,2,1,6,-6,1401,1348,110,121,1,0,111,121,20,100,141
761,Nov 17 2010,Friendly in France,Mali,DR Congo,1512,1407,3,1,11,-11,1523,1396,79,116,3,-4,82,112,20,0,105
762,Nov 17 2010,Friendly in Montenegro,Montenegro,Azerbaijan,1719,1461,2,0,3,-3,1722,1458,35,102,0,-2,35,100,20,100,358
763,Nov 17 2010,Friendly in the Netherlands,Netherlands,Turkey,2103,1779,1,0,2,-2,2105,1777,1,20,1,1,2,21,20,100,424
764,Nov 17 2010,Friendly in Northern Ireland,Northern Ireland,Morocco,1580,1566,1,1,-3,3,1577,1569,68,67,-2,2,66,69,20,100,114
765,Nov 17 2010,Friendly in Oman,Oman,Belarus,1557,1647,0,4,-19,19,1538,1666,83,42,-5,4,78,46,20,100,10
766,Nov 17 2010,Friendly in Panama,Panama,Honduras,1577,1686,2,0,15,-15,1592,1671,57,45,4,-2,61,43,20,100,-9
767,Nov 17 2010,Friendly in Poland,Poland,Ivory Coast,1653,1782,3,1,16,-16,1669,1766,41,28,3,-4,44,24,20,100,-29
768,Nov 17 2010,Friendly in Portugal,Portugal,Spain,1870,2143,4,0,27,-27,1897,2116,6,1,2,0,8,1,20,100,-173
769,Nov 17 2010,Friendly in Russia,Russia,Belgium,1854,1593,0,2,-27,27,1827,1620,15,49,-2,6,13,55,20,100,361
770,Nov 17 2010,Friendly in France,Senegal,Gabon,1570,1574,2,1,10,-10,1580,1564,60,76,4,-5,64,71,20,0,-4
771,Nov 17 2010,Friendly in Slovakia,Slovakia,Bosnia and Herzegovina,1672,1612,2,3,-14,14,1658,1626,50,52,-3,2,47,54,20,100,160
772,Nov 17 2010,Friendly in Slovenia,Slovenia,Georgia,1710,1489,1,2,-17,17,1693,1506,42,86,-2,3,40,89,20,100,321
773,Nov 17 2010,Friendly tournament in South Africa,South Africa,United States,1622,1753,0,1,-14,14,1608,1767,60,20,-3,3,57,23,30,100,-31
774,Nov 17 2010,Friendly in Sweden,Sweden,Germany,1809,2071,0,0,4,-4,1813,2067,14,4,0,0,14,4,20,100,-162
775,Nov 17 2010,Friendly in Switzerland,Switzerland,Ukraine,1755,1807,2,2,-1,1,1754,1808,27,17,-1,-1,26,16,20,100,48
776,Nov 17 2010,Friendly in Tajikistan,Tajikistan,Afghanistan,1272,774,1,0,1,-1,1273,773,138,210,0,0,138,210,20,0,498
777,Nov 17 2010,African Nations Cup qualifier in Togo,Togo,Chad,1395,1220,0,0,-13,13,1382,1233,116,146,-2,2,114,148,40,100,275
778,Nov 18 2010,Friendly in Qatar,Qatar,Haiti,1510,1420,0,1,-15,15,1495,1435,94,102,-4,3,90,105,20,100,190
779,Nov 18 2010,Friendly in the United Arab Emirates,United Arab Emirates,India,1431,1166,5,0,4,-4,1435,1162,103,167,2,-2,105,165,20,100,365
780,Nov 21 2010,Friendly in Indonesia,Indonesia,East Timor,1265,531,6,0,0,0,1265,531,140,229,0,0,140,229,20,100,834
781,Nov 22 2010,Gulf Cup in Yemen,Kuwait,Qatar,1550,1495,1,0,17,-17,1567,1478,67,98,4,-4,71,94,40,0,55
782,Nov 22 2010,Gulf Cup in Yemen,Yemen,Saudi Arabia,1368,1685,0,4,-17,17,1351,1702,121,37,-1,2,120,39,40,100,-217
783,Nov 23 2010,Gulf Cup in Yemen,Bahrain,Oman,1519,1538,1,1,1,-1,1520,1537,83,78,0,0,83,78,20,0,-19
784,Nov 23 2010,Gulf Cup in Yemen,Iraq,United Arab Emirates,1568,1435,0,0,-7,7,1561,1442,76,103,-3,1,73,104,40,0,133
785,Nov 23 2010,Friendly in Tanzania,Tanzania,Kenya,1330,1330,1,0,7,-7,1337,1323,123,129,1,-2,124,127,20,100,100
786,Nov 24 2010,Friendly in Indonesia,Indonesia,Taiwan,1265,924,2,0,2,-2,1267,922,138,195,1,0,139,195,20,100,441
787,Nov 25 2010,Gulf Cup in Yemen,Kuwait,Saudi Arabia,1567,1702,0,0,7,-7,1574,1695,64,41,3,-1,67,40,40,0,-135
788,Nov 25 2010,Gulf Cup in Yemen,Yemen,Qatar,1351,1478,1,2,-18,18,1333,1496,128,86,-4,4,124,90,40,100,-27
789,Nov 26 2010,CONCACAF Ch q & Car Ch in Martinique,Cuba,Trinidad and Tobago,1464,1544,2,0,37,-37,1501,1507,82,93,7,-8,89,85,40,0,-80
790,Nov 26 2010,Gulf Cup in Yemen,Iraq,Bahrain,1561,1520,3,2,18,-18,1579,1502,57,93,8,-5,65,88,40,0,41
791,Nov 26 2010,CONCACAF Ch q & Car Ch in Martinique,Martinique,Grenada,1388,1262,1,1,-11,11,1377,1273,121,135,-4,3,117,138,40,100,226
792,Nov 26 2010,Gulf Cup in Yemen,Oman,United Arab Emirates,1537,1442,0,0,-5,5,1532,1447,78,102,0,1,78,103,20,100,195
793,Nov 26 2010,Friendly in Singapore,Singapore,Laos,1341,862,4,0,1,-1,1342,861,121,205,0,-1,121,204,20,100,579
794,Nov 27 2010,CONCACAF Ch q & Car Ch in Martinique,Guadeloupe,Guyana,1494,1332,1,1,-9,9,1485,1341,94,119,-1,3,93,122,40,0,162
795,Nov 27 2010,CONCACAF Ch q & Car Ch in Martinique,Jamaica,Antigua and Barbuda,1627,1251,3,1,6,-6,1633,1245,51,146,1,-1,52,145,40,0,376
796,Nov 27 2010,CECAFA Cup in Tanzania,Tanzania,Zambia,1337,1550,0,1,-14,14,1323,1564,129,68,-3,4,126,72,40,100,-113
797,Nov 28 2010,CECAFA Cup in Tanzania,Burundi,Somalia,1204,927,2,0,10,-10,1214,917,149,197,2,-2,151,195,40,0,277
798,Nov 28 2010,CONCACAF Ch q & Car Ch in Martinique,Grenada,Trinidad and Tobago,1273,1507,1,0,32,-32,1305,1475,126,105,6,-10,132,95,40,0,-234
799,Nov 28 2010,CONCACAF Ch q & Car Ch in Martinique,Martinique,Cuba,1377,1501,0,1,-19,19,1358,1520,121,75,-2,7,119,82,40,100,-24
800,Nov 28 2010,Gulf Cup in Yemen,Qatar,Saudi Arabia,1496,1695,1,1,10,-10,1506,1685,83,42,4,-1,87,41,40,0,-199
801,Nov 28 2010,CECAFA Cup in Tanzania,Rwanda,Ivory Coast,1348,1766,2,1,37,-37,1385,1729,106,42,7,-9,113,33,40,0,-418
802,Nov 28 2010,Gulf Cup in Yemen,Yemen,Kuwait,1333,1574,0,3,-22,22,1311,1596,136,52,-6,8,130,60,40,100,-141
803,Nov 28 2010,CECAFA Cup in Tanzania,Zanzibar,Sudan,1311,1366,2,0,35,-35,1346,1331,110,129,10,-5,120,124,40,0,-55
804,Nov 29 2010,CONCACAF Ch q & Car Ch in Martinique,Antigua and Barbuda,Guyana,1245,1341,1,0,25,-25,1270,1316,135,134,5,-6,140,128,40,0,-96
805,Nov 29 2010,Gulf Cup in Yemen,Iraq,Oman,1579,1532,0,0,-3,3,1576,1535,70,78,-2,0,68,78,40,0,47
806,Nov 29 2010,CONCACAF Ch q & Car Ch in Martinique,Jamaica,Guadeloupe,1633,1485,2,0,18,-18,1651,1467,48,100,2,-4,50,96,40,0,148
807,Nov 29 2010,CECAFA Cup in Tanzania,Malawi,Kenya,1401,1323,3,2,16,-16,1417,1307,107,136,2,-5,109,131,40,0,78
808,Nov 29 2010,Gulf Cup in Yemen,United Arab Emirates,Bahrain,1447,1502,3,1,35,-35,1482,1467,81,103,11,-7,92,96,40,0,-55
809,Nov 29 2010,CECAFA Cup in Tanzania,Uganda,Ethiopia,1564,1285,2,1,7,-7,1571,1278,70,138,1,0,71,138,40,0,279
810,Nov 30 2010,CECAFA Cup in Tanzania,Burundi,Zambia,1214,1564,0,0,15,-15,1229,1549,147,79,2,-3,149,76,40,0,-350
811,Nov 30 2010,CONCACAF Ch q & Car Ch in Martinique,Cuba,Grenada,1520,1305,0,0,-11,11,1509,1316,86,124,-2,4,84,128,30,100,315
812,Nov 30 2010,CONCACAF Ch q & Car Ch in Martinique,Martinique,Trinidad and Tobago,1358,1475,0,1,-19,19,1339,1494,123,86,-2,4,121,90,40,100,-17
813,Nov 30 2010,CECAFA Cup in Tanzania,Tanzania,Somalia,1323,917,3,0,4,-4,1327,913,125,195,0,0,125,195,40,100,506
814,Dec 1 2010,CONCACAF Ch q & Car Ch in Martinique,Guadeloupe,Antigua and Barbuda,1467,1270,1,0,10,-10,1477,1260,94,144,1,-2,95,142,40,0,197
815,Dec 1 2010,Southeast Asian Champ in Indonesia,Indonesia,Malaysia,1267,1176,5,1,19,-19,1286,1157,133,174,4,-7,137,167,40,100,191
816,Dec 1 2010,CECAFA Cup in Tanzania,Ivory Coast,Zanzibar,1729,1346,1,0,4,-4,1733,1342,31,119,1,0,32,119,40,0,383
817,Dec 1 2010,CONCACAF Ch q & Car Ch in Martinique,Jamaica,Guyana,1651,1316,4,0,10,-10,1661,1306,44,136,3,-4,47,132,40,0,335
818,Dec 1 2010,Southeast Asian Champ in Indonesia,Laos,Thailand,861,1455,2,2,19,-19,880,1436,198,108,3,-3,201,105,40,0,-594
819,Dec 1 2010,CECAFA Cup in Tanzania,Rwanda,Sudan,1385,1331,0,0,-3,3,1382,1334,113,123,0,0,113,123,40,0,54
820,Dec 2 2010,CECAFA Cup in Tanzania,Ethiopia,Kenya,1278,1307,2,1,22,-22,1300,1285,127,147,6,-8,133,139,40,0,-29
821,Dec 2 2010,Gulf Cup in Yemen,Iraq,Kuwait,1576,1596,2,2,1,-1,1577,1595,66,60,1,0,67,60,20,0,-20
822,Dec 2 2010,CECAFA Cup in Tanzania,Malawi,Uganda,1417,1571,1,1,8,-8,1425,1563,109,75,0,-2,109,73,40,0,-154
823,Dec 2 2010,Southeast Asian Champ in Vietnam,Philippines,Singapore,863,1342,1,1,18,-18,881,1324,199,131,2,-6,201,125,40,0,-479
824,Dec 2 2010,Gulf Cup in Yemen,Saudi Arabia,United Arab Emirates,1685,1482,1,0,9,-9,1694,1473,39,97,1,-2,40,95,40,0,203
825,Dec 2 2010,Southeast Asian Champ in Vietnam,Vietnam,Myanmar,1304,1164,7,1,17,-17,1321,1147,121,178,6,-8,127,170,40,100,240
826,Dec 3 2010,Caribbean Championship in Martinique,Guadeloupe,Cuba,1477,1509,2,1,22,-22,1499,1487,84,100,5,-8,89,92,40,0,-32
827,Dec 3 2010,Caribbean Championship in Martinique,Jamaica,Grenada,1661,1316,2,1,5,-5,1666,1311,45,129,1,0,46,129,40,0,345
828,Dec 3 2010,CECAFA Cup in Tanzania,Rwanda,Zanzibar,1382,1342,0,0,-2,2,1380,1344,119,119,-3,0,116,119,30,0,40
829,Dec 3 2010,CECAFA Cup in Tanzania,Zambia,Somalia,1549,913,6,0,2,-2,1551,911,76,195,0,0,76,195,30,0,636
830,Dec 4 2010,CECAFA Cup in Tanzania,Ethiopia,Malawi,1300,1425,1,1,7,-7,1307,1418,131,109,1,0,132,109,40,0,-125
831,Dec 4 2010,Southeast Asian Champ in Indonesia,Indonesia,Laos,1286,880,6,0,4,-4,1290,876,135,202,1,0,136,202,20,0,406
832,Dec 4 2010,Southeast Asian Champ in Indonesia,Malaysia,Thailand,1157,1436,0,0,13,-13,1170,1423,154,111,6,-3,160,108,40,0,-279
833,Dec 4 2010,CECAFA Cup in Tanzania,Tanzania,Burundi,1327,1229,2,0,15,-15,1342,1214,116,153,4,-2,120,151,40,100,198
834,Dec 5 2010,Caribbean Championship in Martinique,Cuba,Grenada,1487,1311,1,0,11,-11,1498,1300,88,135,2,-3,90,132,40,0,176
835,Dec 5 2010,Caribbean Championship in Martinique,Guadeloupe,Jamaica,1499,1666,1,1,9,-9,1508,1657,81,52,4,-3,85,49,40,0,-167
836,Dec 5 2010,CECAFA Cup in Tanzania,Ivory Coast,Sudan,1733,1334,3,0,6,-6,1739,1328,28,127,2,-2,30,125,40,0,399
837,Dec 5 2010,Gulf Cup in Yemen,Kuwait,Saudi Arabia,1595,1694,1,0,26,-26,1621,1668,50,50,5,-5,55,45,40,0,-99
838,Dec 5 2010,Southeast Asian Champ in Vietnam,Singapore,Myanmar,1324,1147,2,1,11,-11,1335,1136,121,172,2,-1,123,171,40,0,177
839,Dec 5 2010,CECAFA Cup in Tanzania,Uganda,Kenya,1563,1285,2,0,10,-10,1573,1275,65,137,4,1,69,138,40,0,278
840,Dec 5 2010,Southeast Asian Champ in Vietnam,Vietnam,Philippines,1321,881,0,2,-57,57,1264,938,155,181,-14,10,141,191,40,100,540
841,Dec 7 2010,CECAFA Cup in Tanzania,Ethiopia,Zambia,1307,1551,2,1,32,-32,1339,1519,112,86,9,-5,121,81,40,0,-244
842,Dec 7 2010,Southeast Asian Champ in Indonesia,Indonesia,Thailand,1290,1423,2,1,22,-22,1312,1401,123,114,6,-3,129,111,40,100,-33
843,Dec 7 2010,CECAFA Cup in Tanzania,Ivory Coast,Malawi,1739,1418,1,0,5,-5,1744,1413,24,107,3,1,27,108,40,0,321
844,Dec 7 2010,Southeast Asian Champ in Indonesia,Malaysia,Laos,1170,876,5,1,12,-12,1182,864,156,204,2,-1,158,203,40,0,294
845,Dec 8 2010,Southeast Asian Champ in Vietnam,Myanmar,Philippines,1136,938,0,0,-10,10,1126,948,171,191,0,0,171,191,30,100,298
846,Dec 8 2010,CECAFA Cup in Tanzania,Tanzania,Rwanda,1342,1380,1,0,16,-16,1358,1364,118,120,1,-2,119,118,40,100,62
847,Dec 8 2010,CECAFA Cup in Tanzania,Uganda,Zanzibar,1573,1344,2,2,-12,12,1561,1356,77,121,-4,-1,73,120,40,0,229
848,Dec 8 2010,Southeast Asian Champ in Vietnam,Vietnam,Singapore,1264,1335,1,0,18,-18,1282,1317,135,132,3,-4,138,128,30,0,-71
849,Dec 10 2010,Friendly in Turkey,Bosnia and Herzegovina,Poland,1626,1669,2,2,1,-1,1627,1668,54,45,0,-1,54,44,20,0,-43
850,Dec 10 2010,CECAFA Cup in Tanzania,Ivory Coast,Ethiopia,1744,1339,1,0,4,-4,1748,1335,27,125,0,-2,27,123,40,0,405
851,Dec 10 2010,CECAFA Cup in Tanzania,Tanzania,Uganda,1358,1561,0,0,6,-6,1364,1555,117,73,1,0,118,73,40,100,-103
852,Dec 12 2010,CECAFA Cup in Tanzania,Tanzania,Ivory Coast,1364,1748,1,0,33,-33,1397,1715,106,43,6,-8,112,35,40,100,-284
853,Dec 12 2010,CECAFA Cup in Tanzania,Uganda,Ethiopia,1555,1335,4,3,9,-9,1564,1326,71,127,1,-2,72,125,40,0,220
854,Dec 15 2010,Southeast Asian Champ in Malaysia,Malaysia,Vietnam,1182,1282,2,0,30,-30,1212,1252,148,150,5,-6,153,144,40,100,0
855,Dec 16 2010,Southeast Asian Champ in Indonesia,Indonesia,Philippines,1312,948,1,0,3,-3,1315,945,129,191,0,0,129,191,30,0,364
856,Dec 16 2010,Friendly in Qatar,Qatar,Egypt,1506,1792,2,1,15,-15,1521,1777,75,22,6,-2,81,20,20,100,-186
857,Dec 18 2010,Friendly in China,China,Estonia,1614,1490,3,0,8,-8,1622,1482,53,94,2,-1,55,93,20,100,224
858,Dec 18 2010,Friendly in Honduras,Honduras,Panama,1671,1592,2,1,5,-5,1676,1587,42,64,0,-1,42,63,20,100,179
859,Dec 18 2010,Friendly in Iraq,Iraq,Syria,1577,1536,0,1,-14,14,1563,1550,79,76,-6,0,73,76,20,100,141
860,Dec 18 2010,Southeast Asian Champ in Vietnam,Vietnam,Malaysia,1252,1212,0,0,-8,8,1244,1220,146,149,-1,2,145,151,40,100,140
861,Dec 19 2010,Southeast Asian Champ in Indonesia,Indonesia,Philippines,1315,945,1,0,3,-3,1318,942,127,191,1,0,128,191,30,0,370
862,Dec 22 2010,Friendly in China,China,Macedonia,1622,1572,1,0,6,-6,1628,1566,53,73,1,-2,54,71,20,100,150
863,Dec 22 2010,Friendly in Qatar,Qatar,Estonia,1521,1482,2,0,9,-9,1530,1473,75,95,3,-1,78,94,20,100,139
864,Dec 22 2010,Friendly in Syria,Syria,Iraq,1550,1563,0,1,-12,12,1538,1575,76,63,0,5,76,68,20,100,87
865,Dec 24 2010,Friendly in Egypt,Kuwait,North Korea,1621,1518,2,1,7,-7,1628,1511,52,85,2,-1,54,84,20,0,103
866,Dec 25 2010,Friendly in the United Arab Emirates,Bahrain,Uzbekistan,1467,1509,1,1,1,-1,1468,1508,97,85,0,0,97,85,20,0,-42
867,Dec 26 2010,Southeast Asian Champ in Malaysia,Malaysia,Indonesia,1220,1318,3,0,35,-35,1255,1283,135,146,8,-9,143,137,40,100,2
868,Dec 27 2010,Friendly in Egypt,Kuwait,North Korea,1628,1511,2,2,-3,3,1625,1514,58,84,-2,0,56,84,20,0,117
869,Dec 28 2010,Friendly in Algeria,Algeria,Chad,1460,1233,3,1,4,-4,1464,1229,98,149,0,0,98,149,20,100,327
870,Dec 28 2010,Friendly in the United Arab Emirates,Bahrain,Jordan,1468,1479,2,1,10,-10,1478,1469,89,99,4,-3,93,96,20,0,-11
871,Dec 28 2010,Friendly in Qatar,Qatar,Iran,1530,1696,0,0,2,-2,1532,1694,78,39,0,0,78,39,20,100,-66
872,Dec 28 2010,Friendly in Saudi Arabia,Saudi Arabia,Iraq,1668,1575,0,1,-15,15,1653,1590,54,56,-5,6,49,62,20,100,193
873,Dec 29 2010,Southeast Asian Champ in Indonesia,Indonesia,Malaysia,1283,1255,2,1,13,-13,1296,1242,129,149,4,-3,133,146,40,100,128
874,Dec 30 2010,Friendly in the United Arab Emirates,South Korea,Syria,1736,1538,1,0,5,-5,1741,1533,29,78,1,-1,30,77,20,0,198
875,Dec 31 2010,Friendly in Bahrain,Bahrain,Saudi Arabia,1478,1653,0,1,-8,8,1470,1661,97,43,-2,3,95,46,20,100,-75
876,Dec 31 2010,Friendly in Egypt,Kuwait,Zambia,1625,1519,4,0,13,-13,1638,1506,50,92,3,-5,53,87,20,0,106
877,Dec 31 2010,Friendly in Qatar,Qatar,North Korea,1532,1514,0,1,-13,13,1519,1527,86,74,-4,5,82,79,20,100,118
