,date,tournament,home_team,away_team,home_team_rating,away_team_rating,home_goals,away_goals,home_team_rating_change,away_team_rating_change,home_team_new_rating,away_team_new_rating,home_team_rank,away_team_rank,home_team_rank_change,away_team_rank_change,home_team_new_rank,away_team_new_rank,k,hadv,rdiff
0,Jan 2 2019,Friendly in the United Arab Emirates,Oman,Thailand,1525,1382,2,0,9,-9,1534,1373,71,116,3,-3,74,113,20,0,143
1,Jan 5 2019,Asian Cup in the United Arab Emirates,United Arab Emirates,Bahrain,1482,1431,1,1,-10,10,1472,1441,91,95,-3,2,88,97,50,100,151
2,Jan 6 2019,Asian Cup in the United Arab Emirates,India,Thailand,1218,1373,4,1,62,-62,1280,1311,129,155,13,-21,142,134,50,0,-155
3,Jan 6 2019,Asian Cup in the United Arab Emirates,Jordan,Australia,1446,1735,1,0,42,-42,1488,1693,74,51,11,-8,85,43,50,0,-289
4,Jan 6 2019,Asian Cup in the United Arab Emirates,Palestine,Syria,1376,1598,0,0,14,-14,1390,1584,104,64,4,-3,108,61,50,0,-222
5,Jan 7 2019,Asian Cup in the United Arab Emirates,China,Kyrgyzstan,1515,1289,2,1,11,-11,1526,1278,75,144,2,-2,77,142,50,0,226
6,Jan 7 2019,Asian Cup in the United Arab Emirates,Iran,Yemen,1823,1188,5,0,3,-3,1826,1185,19,164,0,0,19,164,50,0,635
7,Jan 7 2019,Asian Cup in the United Arab Emirates,South Korea,Philippines,1778,1171,1,0,1,-1,1779,1170,23,170,0,-1,23,169,20,0,607
8,Jan 8 2019,Friendly in Qatar,Finland,Sweden,1621,1851,1,0,16,-16,1637,1835,46,19,3,-1,49,18,20,0,-230
9,Jan 8 2019,Asian Cup in the United Arab Emirates,Iraq,Vietnam,1579,1335,3,2,10,-10,1589,1325,59,131,2,-4,61,127,50,0,244
10,Jan 8 2019,Asian Cup in the United Arab Emirates,Saudi Arabia,North Korea,1581,1429,4,0,28,-28,1609,1401,50,112,6,-6,56,106,50,0,152
11,Jan 9 2019,Asian Cup in the United Arab Emirates,Japan,Turkmenistan,1731,1247,3,2,3,-3,1734,1244,35,153,0,-1,35,152,50,0,484
12,Jan 9 2019,Asian Cup in the United Arab Emirates,Qatar,Lebanon,1528,1451,2,0,29,-29,1557,1422,60,106,8,-6,68,100,50,0,77
13,Jan 9 2019,Asian Cup in the United Arab Emirates,Uzbekistan,Oman,1590,1534,2,1,21,-21,1611,1513,50,88,5,-7,55,81,50,0,56
14,Jan 10 2019,Asian Cup in the United Arab Emirates,Jordan,Syria,1488,1584,2,0,48,-48,1536,1536,63,85,11,-11,74,74,50,0,-96
15,Jan 10 2019,Asian Cup in the United Arab Emirates,Thailand,Bahrain,1311,1441,1,0,34,-34,1345,1407,104,108,15,-6,119,102,50,0,-130
16,Jan 10 2019,Asian Cup in the United Arab Emirates,United Arab Emirates,India,1472,1280,2,0,12,-12,1484,1268,83,145,3,-2,86,143,50,100,292
17,Jan 11 2019,Asian Cup in the United Arab Emirates,Australia,Palestine,1693,1390,3,0,13,-13,1706,1377,41,116,1,-4,42,112,50,0,303
18,Jan 11 2019,Asian Cup in the United Arab Emirates,China,Philippines,1526,1170,3,0,10,-10,1536,1160,71,169,3,0,74,169,50,0,356
19,Jan 11 2019,Friendly in Qatar,Estonia,Finland,1468,1637,2,1,15,-15,1483,1622,83,53,4,-2,87,51,20,0,-169
20,Jan 11 2019,Friendly in Qatar,Iceland,Sweden,1668,1835,2,2,4,-4,1672,1831,46,18,0,0,46,18,20,0,-167
21,Jan 11 2019,Asian Cup in the United Arab Emirates,South Korea,Kyrgyzstan,1779,1278,1,0,3,-3,1782,1275,23,143,0,-1,23,142,50,0,501
22,Jan 12 2019,Asian Cup in the United Arab Emirates,Iran,Vietnam,1826,1325,2,0,4,-4,1830,1321,19,132,0,-2,19,130,50,0,501
23,Jan 12 2019,Asian Cup in the United Arab Emirates,Iraq,Yemen,1589,1185,3,0,8,-8,1597,1177,59,170,1,-3,60,167,50,0,404
24,Jan 12 2019,Asian Cup in the United Arab Emirates,Saudi Arabia,Lebanon,1609,1422,2,0,19,-19,1628,1403,43,109,7,-5,50,104,50,0,187
25,Jan 13 2019,Asian Cup in the United Arab Emirates,Japan,Oman,1734,1513,1,0,11,-11,1745,1502,33,84,1,-1,34,83,50,0,221
26,Jan 13 2019,Asian Cup in the United Arab Emirates,Qatar,North Korea,1557,1401,6,0,31,-31,1588,1370,59,120,4,-7,63,113,50,0,156
27,Jan 13 2019,Asian Cup in the United Arab Emirates,Uzbekistan,Turkmenistan,1611,1244,4,0,10,-10,1621,1234,52,152,2,0,54,152,50,0,367
28,Jan 14 2019,Asian Cup in the United Arab Emirates,Bahrain,India,1407,1268,1,0,15,-15,1422,1253,97,155,2,-6,99,149,50,0,139
29,Jan 14 2019,Asian Cup in the United Arab Emirates,United Arab Emirates,Thailand,1484,1345,1,1,-15,15,1469,1360,94,111,-4,4,90,115,50,100,239
30,Jan 15 2019,Asian Cup in the United Arab Emirates,Australia,Syria,1706,1536,3,2,14,-14,1720,1522,40,82,1,-4,41,78,50,0,170
31,Jan 15 2019,Friendly in Qatar,Estonia,Iceland,1483,1672,0,0,5,-5,1488,1667,86,46,0,0,86,46,20,0,-189
32,Jan 15 2019,Asian Cup in the United Arab Emirates,Jordan,Palestine,1536,1377,0,0,-11,11,1525,1388,80,105,-3,3,77,108,50,0,159
33,Jan 16 2019,Asian Cup in the United Arab Emirates,Iran,Iraq,1830,1597,0,0,-15,15,1815,1612,19,54,0,3,19,57,40,100,333
34,Jan 16 2019,Asian Cup in the United Arab Emirates,Kyrgyzstan,Philippines,1275,1160,3,1,26,-26,1301,1134,130,177,6,-4,136,173,50,0,115
35,Jan 16 2019,Asian Cup in the United Arab Emirates,South Korea,China,1782,1536,2,0,15,-15,1797,1521,19,82,2,-4,21,78,50,0,246
36,Jan 16 2019,Asian Cup in the United Arab Emirates,Vietnam,Yemen,1321,1177,2,0,23,-23,1344,1154,110,171,10,-2,120,169,50,0,144
37,Jan 17 2019,Asian Cup in the United Arab Emirates,Japan,Uzbekistan,1745,1621,2,1,16,-16,1761,1605,20,62,7,-4,27,58,50,0,124
38,Jan 17 2019,Asian Cup in the United Arab Emirates,Lebanon,North Korea,1403,1370,4,1,40,-40,1443,1330,88,139,8,-13,96,126,50,0,33
39,Jan 17 2019,Asian Cup in the United Arab Emirates,Oman,Turkmenistan,1502,1234,3,1,13,-13,1515,1221,77,156,3,-2,80,154,50,0,268
40,Jan 17 2019,Asian Cup in the United Arab Emirates,Qatar,Saudi Arabia,1588,1628,2,0,42,-42,1630,1586,35,76,14,-13,49,63,50,0,-40
41,Jan 20 2019,Asian Cup in the United Arab Emirates,China,Thailand,1521,1360,2,1,14,-14,1535,1346,70,124,4,-5,74,119,50,0,161
42,Jan 20 2019,Asian Cup in the United Arab Emirates,Iran,Oman,1815,1515,2,0,11,-11,1826,1504,19,84,0,-2,19,82,50,0,300
43,Jan 20 2019,Asian Cup in the United Arab Emirates,Jordan,Vietnam,1525,1344,1,1,-12,12,1513,1356,86,113,-5,3,81,116,50,0,181
44,Jan 21 2019,Asian Cup in the United Arab Emirates,Australia,Uzbekistan,1720,1605,0,0,-8,8,1712,1613,43,52,-1,3,42,55,30,100,215
45,Jan 21 2019,Asian Cup in the United Arab Emirates,Japan,Saudi Arabia,1761,1586,1,0,13,-13,1774,1573,21,63,3,0,24,63,50,0,175
46,Jan 21 2019,Asian Cup in the United Arab Emirates,United Arab Emirates,Kyrgyzstan,1469,1301,3,2,9,-9,1478,1292,84,144,3,-4,87,140,50,100,268
47,Jan 22 2019,Asian Cup in the United Arab Emirates,Qatar,Iraq,1630,1612,1,0,24,-24,1654,1588,47,67,1,-5,48,62,50,0,18
48,Jan 22 2019,Asian Cup in the United Arab Emirates,South Korea,Bahrain,1797,1422,2,1,5,-5,1802,1417,21,100,0,0,21,100,50,0,375
49,Jan 24 2019,Asian Cup in the United Arab Emirates,Iran,China,1826,1535,3,0,14,-14,1840,1521,17,80,1,-3,18,77,50,0,291
50,Jan 24 2019,Asian Cup in the United Arab Emirates,Japan,Vietnam,1774,1356,1,0,4,-4,1778,1352,24,118,0,-1,24,117,50,0,418
51,Jan 25 2019,Asian Cup in the United Arab Emirates,Qatar,South Korea,1654,1802,1,0,35,-35,1689,1767,40,31,4,-5,44,26,50,0,-148
52,Jan 25 2019,Asian Cup in the United Arab Emirates,United Arab Emirates,Australia,1478,1712,1,0,34,-34,1512,1678,77,48,5,-3,82,45,50,100,-134
53,Jan 27 2019,Friendly in the United States,United States,Panama,1743,1568,3,0,6,-6,1749,1562,33,65,1,0,34,65,20,100,275
54,Jan 28 2019,Asian Cup in the United Arab Emirates,Japan,Iran,1778,1840,3,0,51,-51,1829,1789,15,26,4,-4,19,22,50,0,-62
55,Jan 29 2019,Asian Cup in the United Arab Emirates,United Arab Emirates,Qatar,1512,1689,0,4,-37,37,1475,1726,96,32,-7,6,89,38,50,100,-77
56,Feb 1 2019,Asian Cup in the United Arab Emirates,Qatar,Japan,1726,1829,3,1,48,-48,1774,1781,10,27,14,-4,24,23,50,0,-103
57,Feb 2 2019,Friendly in the United States,United States,Costa Rica,1749,1724,2,0,10,-10,1759,1714,25,42,5,-1,30,41,20,100,125
58,Feb 16 2019,Friendly in the Dominican Republic,Dominican Republic,Guadeloupe,1265,1204,1,0,6,-6,1271,1198,142,163,1,-1,143,162,20,100,161
59,Feb 21 2019,Friendly in Turkey,Kazakhstan,Moldova,1330,1324,1,0,10,-10,1340,1314,118,135,4,-3,122,132,20,0,6
60,Feb 23 2019,Friendly in Sint Maarten,Sint Maarten,Saint BarthÃ©lemy,814,699,1,1,-6,6,808,705,206,217,0,1,206,218,20,100,215
61,Feb 25 2019,Friendly in Cuba,Cuba,Bermuda,1339,1183,2,2,-6,6,1333,1189,127,163,-2,1,125,164,20,100,256
62,Feb 27 2019,Friendly in Cuba,Cuba,Bermuda,1333,1189,5,0,8,-8,1341,1181,117,166,4,-1,121,165,20,100,244
63,Feb 28 2019,Windward Islands Champ in St Vincent & Grenadines,Grenada,Saint Lucia,1071,1141,1,0,18,-18,1089,1123,173,177,6,-3,179,174,30,0,-70
64,Feb 28 2019,Windward Islands Champ in St Vincent & Grenadines,St Vincent & Grenadines,Barbados,1080,1134,2,0,20,-20,1100,1114,175,177,2,-2,177,175,30,100,46
65,Mar 2 2019,Windward Islands Champ in St Vincent & Grenadines,Dominica,Grenada,1044,1089,1,0,17,-17,1061,1072,185,191,1,-6,186,185,30,0,-45
66,Mar 2 2019,Windward Islands Champ in St Vincent & Grenadines,St Vincent & Grenadines,Saint Lucia,1100,1123,2,1,12,-12,1112,1111,173,178,2,-2,175,176,30,100,77
67,Mar 3 2019,Friendly in Bolivia,Bolivia,Nicaragua,1655,1281,2,2,-9,9,1646,1290,50,141,-1,0,49,141,20,100,474
68,Mar 4 2019,Windward Islands Champ in St Vincent & Grenadines,Barbados,Grenada,1114,1072,0,0,-2,2,1112,1074,174,183,0,1,174,184,30,0,42
69,Mar 4 2019,Windward Islands Champ in St Vincent & Grenadines,Dominica,Saint Lucia,1061,1111,1,1,2,-2,1063,1109,186,176,0,0,186,176,30,0,-50
70,Mar 6 2019,Windward Islands Champ in St Vincent & Grenadines,Barbados,Saint Lucia,1112,1109,2,0,22,-22,1134,1087,170,182,2,-3,172,179,30,0,3
71,Mar 6 2019,Friendly in the United States,El Salvador,Guatemala,1454,1495,3,1,17,-17,1471,1478,89,88,2,-2,91,86,20,0,-41
72,Mar 6 2019,Windward Islands Champ in St Vincent & Grenadines,St Vincent & Grenadines,Dominica,1112,1063,2,1,9,-9,1121,1054,176,188,-1,-1,175,187,20,0,49
73,Mar 8 2019,Windward Islands Champ in St Vincent & Grenadines,Barbados,Dominica,1134,1054,2,0,17,-17,1151,1037,168,187,2,0,170,187,30,0,80
74,Mar 8 2019,Windward Islands Champ in St Vincent & Grenadines,St Vincent & Grenadines,Grenada,1121,1074,1,1,-6,6,1115,1080,175,176,0,4,175,180,30,100,147
75,Mar 9 2019,Friendly in Cambodia,Cambodia,Bangladesh,792,791,0,1,-13,13,779,804,214,204,-3,3,211,207,20,100,101
76,Mar 10 2019,Friendly in Anguilla,Anguilla,Saint Martin,584,829,2,1,14,-14,598,815,230,205,0,0,230,205,20,100,-145
77,Mar 10 2019,Friendly in South Africa,Mozambique,Eswatini,1300,1202,1,1,-3,3,1297,1205,140,161,-2,0,138,161,20,0,98
78,Mar 16 2019,Friendly in the Bahamas,Bahamas,Turks and Caicos Islands,856,779,6,1,11,-11,867,768,202,215,0,-2,202,213,20,100,177
79,Mar 16 2019,Friendly in Suriname,Suriname,Guyana,1259,1185,3,1,8,-8,1267,1177,144,168,1,-2,145,166,20,100,174
80,Mar 17 2019,Friendly in Saint BarthÃ©lemy,Saint BarthÃ©lemy,Saint Martin,705,815,4,3,10,-10,715,805,212,207,3,-1,215,206,20,100,-10
81,Mar 18 2019,Friendly tournament in Fiji,Fiji,New Caledonia,1210,1222,3,0,20,-20,1230,1202,147,167,5,-7,152,160,30,100,88
82,Mar 18 2019,Friendly in the Solomon Islands,Solomon Islands,Vanuatu,1207,1209,3,1,11,-11,1218,1198,152,164,4,-3,156,161,20,100,98
83,Mar 19 2019,Friendly in Myanmar,Myanmar,Taiwan,1057,972,0,0,-5,5,1052,977,186,192,0,1,186,193,20,100,185
84,Mar 20 2019,Friendly in Germany,Germany,Serbia,1938,1807,1,1,-6,6,1932,1813,9,19,0,0,9,19,20,100,231
85,Mar 20 2019,Friendly tournament in Iraq,Iraq,Syria,1588,1522,1,0,8,-8,1596,1514,58,82,2,-3,60,79,20,0,66
86,Mar 20 2019,Friendly tournament in Malaysia,Malaysia,Singapore,1127,1079,0,1,-21,21,1106,1100,176,172,-1,5,175,177,30,100,148
87,Mar 20 2019,Friendly tournament in Malaysia,Oman,Afghanistan,1504,1149,5,0,7,-7,1511,1142,82,171,0,0,82,171,30,0,355
88,Mar 20 2019,Friendly in Wales,Wales,Trinidad and Tobago,1760,1434,1,0,2,-2,1762,1432,29,99,0,-1,29,98,20,100,426
89,Mar 21 2019,European Championship qual in Austria,Austria,Poland,1764,1752,0,1,-26,26,1738,1778,44,13,-8,11,36,24,40,100,112
90,Mar 21 2019,European Championship qual in Belgium,Belgium,Russia,2035,1753,3,1,6,-6,2041,1747,3,37,0,-2,3,35,40,100,382
91,Mar 21 2019,CONCACAF Nations League q in Anguilla,British Virgin Islands,Turks and Caicos Islands,645,768,2,2,7,-7,652,761,226,213,0,0,226,213,40,0,-123
92,Mar 21 2019,Friendly tournament in China,China,Thailand,1521,1346,0,1,-25,25,1496,1371,92,109,-8,5,84,114,30,100,275
93,Mar 21 2019,European Championship qual in Croatia,Croatia,Azerbaijan,1925,1403,2,1,1,-1,1926,1402,10,105,0,0,10,105,20,0,522
94,Mar 21 2019,European Championship qual in Cyprus,Cyprus,San Marino,1414,835,5,0,2,-2,1416,833,100,204,1,0,101,204,30,0,579
95,Mar 21 2019,European Championship qual in Israel,Israel,Slovenia,1561,1561,1,1,-6,6,1555,1567,68,62,-1,2,67,64,40,100,100
96,Mar 21 2019,European Championship qual in Kazakhstan,Kazakhstan,Scotland,1340,1722,3,0,58,-58,1398,1664,89,54,17,-7,106,47,40,100,-282
97,Mar 21 2019,Friendly in Kosovo,Kosovo,Denmark,1495,1898,2,2,7,-7,1502,1891,82,14,1,0,83,14,20,100,-303
98,Mar 21 2019,Friendly in Kuwait,Kuwait,Nepal,1434,876,0,0,-10,10,1424,886,99,201,-1,0,98,201,20,100,658
99,Mar 21 2019,Friendly tournament in Fiji,Mauritius,New Caledonia,1073,1202,3,1,30,-30,1103,1172,169,172,8,-6,177,166,30,0,-129
100,Mar 21 2019,European Championship qual in the Netherlands,Netherlands,Belarus,1986,1538,4,0,3,-3,1989,1535,5,73,0,0,5,73,20,0,448
101,Mar 21 2019,European Championship qual in North Macedonia,North Macedonia,Latvia,1519,1298,3,1,8,-8,1527,1290,73,143,2,-3,75,140,40,100,321
102,Mar 21 2019,European Championship qual in Northern Ireland,Northern Ireland,Estonia,1622,1488,2,0,12,-12,1634,1476,48,89,2,-2,50,87,40,100,234
103,Mar 21 2019,European Championship qual in Slovakia,Slovakia,Hungary,1748,1610,2,0,12,-12,1760,1598,26,61,5,-2,31,59,40,100,238
104,Mar 21 2019,CONCACAF Nations League q in St Vincent & Grenadines,St Vincent & Grenadines,Bonaire,1115,975,2,1,8,-8,1123,967,174,196,0,-1,174,195,40,100,240
105,Mar 21 2019,Friendly in the United Arab Emirates,United Arab Emirates,Saudi Arabia,1475,1573,2,1,10,-10,1485,1563,81,67,4,-2,85,65,20,100,2
106,Mar 21 2019,Friendly in the United States,United States,Ecuador,1759,1772,1,0,8,-8,1767,1764,24,32,3,-3,27,29,20,100,87
107,Mar 22 2019,European Championship qual in Albania,Albania,Turkey,1515,1691,0,2,-24,24,1491,1715,93,35,-8,4,85,39,40,100,-76
108,Mar 22 2019,African Nations Cup qualifier in Algeria,Algeria,Gambia,1545,1306,1,1,-15,15,1530,1321,78,127,-3,4,75,131,40,100,339
109,Mar 22 2019,European Championship qual in Andorra,Andorra,Iceland,1080,1667,0,2,-3,3,1077,1670,186,46,-2,0,184,46,30,100,-487
110,Mar 22 2019,CONCACAF Nations League q in Anguilla,Anguilla,US Virgin Islands,598,715,0,3,-33,33,565,748,232,215,-1,0,231,215,40,100,-17
111,Mar 22 2019,African Nations Cup qualifier in Botswana,Botswana,Angola,1313,1324,0,1,-25,25,1288,1349,149,111,-8,9,141,120,40,100,89
112,Mar 22 2019,European Championship qual in Bulgaria,Bulgaria,Montenegro,1629,1589,1,1,-8,8,1621,1597,55,58,-2,2,53,60,40,100,140
113,Mar 22 2019,African Nations Cup qualifier in Burkina Faso,Burkina Faso,Mauritania,1526,1356,1,0,7,-7,1533,1349,70,122,3,-2,73,120,40,100,270
114,Mar 22 2019,CONCACAF Nations League q in the Cayman Islands,Cayman Islands,Montserrat,945,722,1,2,-35,35,910,757,201,214,-2,0,199,214,40,100,323
115,Mar 22 2019,European Championship qual in England,England,Czechia,1960,1729,5,0,10,-10,1970,1719,5,36,1,1,6,37,40,100,331
116,Mar 22 2019,Friendly in Guatemala,Guatemala,Costa Rica,1478,1714,1,0,14,-14,1492,1700,82,46,2,-3,84,43,20,100,-136
117,Mar 22 2019,Friendly in Japan,Japan,Colombia,1781,1961,0,1,-8,8,1773,1969,31,8,-4,-1,27,7,20,100,-80
118,Mar 22 2019,European Championship qual in Luxembourg,Luxembourg,Lithuania,1347,1338,2,1,14,-14,1361,1324,112,136,4,-6,116,130,40,100,109
119,Mar 22 2019,African Nations Cup qualifier in Malawi,Malawi,Morocco,1252,1730,0,0,16,-16,1268,1714,136,43,7,-3,143,40,40,100,-378
120,Mar 22 2019,Friendly in the United States,Mexico,Chile,1787,1851,3,1,18,-18,1805,1833,18,17,2,0,20,17,20,0,-64
121,Mar 22 2019,European Championship qual in Moldova,Moldova,France,1314,2094,1,4,-1,1,1313,2095,136,2,-2,0,134,2,20,100,-680
122,Mar 22 2019,African Nations Cup qualifier in Nigeria,Nigeria,Seychelles,1713,969,3,1,0,0,1713,969,41,194,0,0,41,194,20,0,744
123,Mar 22 2019,Friendly in the United States,Peru,Paraguay,1855,1725,1,0,6,-6,1861,1719,16,35,0,2,16,37,20,0,130
124,Mar 22 2019,European Championship qual in Portugal,Portugal,Ukraine,1960,1773,0,0,-14,14,1946,1787,9,20,-1,3,8,23,40,100,287
125,Mar 22 2019,Friendly in South Korea,South Korea,Bolivia,1767,1646,1,0,4,-4,1771,1642,29,49,-1,0,28,49,20,100,221
126,Mar 22 2019,CONCACAF Nations League q in Antigua and Barbuda,Saint Lucia,Aruba,1087,932,3,2,12,-12,1099,920,177,197,2,1,179,198,40,0,155
127,Mar 22 2019,African Nations Cup qualifier in Sudan,Sudan,Equatorial Guinea,1278,1295,1,4,-43,43,1235,1338,160,112,-9,13,151,125,40,100,83
128,Mar 22 2019,African Nations Cup qualifier in Tunisia,Tunisia,Eswatini,1649,1205,4,0,3,-3,1652,1202,48,159,0,0,48,159,20,0,444
129,Mar 22 2019,Friendly tournament in China,Uruguay,Uzbekistan,1923,1613,3,0,8,-8,1931,1605,9,57,1,-1,10,56,30,0,310
130,Mar 22 2019,Friendly in Spain,Venezuela,Argentina,1756,1915,3,1,21,-21,1777,1894,17,13,8,0,25,13,20,0,-159
131,Mar 23 2019,CONCACAF Nations League q in Antigua and Barbuda,Antigua and Barbuda,CuraÃ§ao,1171,1334,2,1,24,-24,1195,1310,159,142,4,-8,163,134,40,100,-63
132,Mar 23 2019,European Championship qual in Bosnia and Herzegovina,Bosnia and Herzegovina,Armenia,1795,1449,2,1,3,-3,1798,1446,21,95,0,0,21,95,40,100,446
133,Mar 23 2019,Friendly in Portugal,Brazil,Panama,2137,1562,1,1,-9,9,2128,1571,1,60,0,3,1,63,20,0,575
134,Mar 23 2019,African Nations Cup qualifier in Burundi,Burundi,Gabon,1364,1406,1,1,-3,3,1361,1409,113,103,1,0,114,103,40,100,58
135,Mar 23 2019,African Nations Cup qualifier in Cameroon,Cameroon,Comoros,1599,1088,3,0,2,-2,1601,1086,58,181,0,0,58,181,20,0,511
136,Mar 23 2019,CONCACAF Nations League q in Dominica,Dominica,Bahamas,1037,867,4,0,13,-13,1050,854,187,202,0,0,187,202,40,100,270
137,Mar 23 2019,CONCACAF Nations League q in El Salvador,El Salvador,Jamaica,1471,1570,2,0,30,-30,1501,1540,71,77,10,-7,81,70,40,100,1
138,Mar 23 2019,European Championship qual in Georgia,Georgia,Switzerland,1546,1922,0,2,-10,10,1536,1932,72,6,-1,3,71,9,40,100,-276
139,Mar 23 2019,African Nations Cup qualifier in Ghana,Ghana,Kenya,1625,1388,1,0,5,-5,1630,1383,51,111,0,-1,51,110,40,100,337
140,Mar 23 2019,European Championship qual in Gibraltar,Gibraltar,Ireland,1104,1704,0,1,-2,2,1102,1706,180,42,-2,0,178,42,30,100,-500
141,Mar 23 2019,CONCACAF Nations League q in Guadeloupe,Guadeloupe,Martinique,1198,1451,0,1,-12,12,1186,1463,170,92,-5,1,165,93,40,100,-153
142,Mar 23 2019,African Nations Cup qualifier in Guinea-Bissau,Guinea-Bissau,Mozambique,1315,1297,2,2,-7,7,1308,1304,137,135,-2,1,135,136,40,100,118
143,Mar 23 2019,CONCACAF Nations League q in Guyana,Guyana,Belize,1177,1155,2,1,13,-13,1190,1142,163,172,1,-2,164,170,40,100,122
144,Mar 23 2019,European Championship qual in Italy,Italy,Finland,1889,1622,2,0,6,-6,1895,1616,11,56,2,-2,13,54,40,100,367
145,Mar 23 2019,African Nations Cup qualifier in Ivory Coast,Ivory Coast,Rwanda,1605,1268,3,0,5,-5,1610,1263,54,147,1,-2,55,145,40,100,437
146,Mar 23 2019,European Championship qual in Liechtenstein,Liechtenstein,Greece,1138,1613,0,2,-6,6,1132,1619,172,51,0,2,172,53,40,100,-375
147,Mar 23 2019,Friendly tournament in Malaysia,Malaysia,Afghanistan,1106,1142,2,1,12,-12,1118,1130,175,175,0,-2,175,173,30,100,64
148,Mar 23 2019,African Nations Cup qualifier in Mali,Mali,South Sudan,1531,1022,3,0,2,-2,1533,1020,72,188,1,0,73,188,20,0,509
149,Mar 23 2019,European Championship qual in Malta,Malta,Faroe Islands,1178,1255,2,1,19,-19,1197,1236,160,151,2,-2,162,149,40,100,23
150,Mar 23 2019,African Nations Cup qualifier in Niger,Niger,Egypt,1312,1617,1,1,11,-11,1323,1606,125,58,5,-2,130,56,30,0,-305
151,Mar 23 2019,Friendly tournament in Malaysia,Oman,Singapore,1511,1100,1,1,-12,12,1499,1112,84,174,-2,2,82,176,30,0,411
152,Mar 23 2019,African Nations Cup qualifier in Senegal,Senegal,Madagascar,1757,1341,2,0,3,-3,1760,1338,31,125,1,-1,32,124,20,0,416
153,Mar 23 2019,European Championship qual in Spain,Spain,Norway,2011,1678,2,1,3,-3,2014,1675,4,46,0,-1,4,45,20,0,333
154,Mar 23 2019,CONCACAF Nations League q in Anguilla,Sint Maarten,Saint Martin,808,805,4,3,20,-20,828,785,205,212,0,-3,205,209,40,0,3
155,Mar 23 2019,CONCACAF Nations League q in Suriname,Suriname,Saint Kitts and Nevis,1267,1247,2,0,20,-20,1287,1227,139,154,3,-2,142,152,40,100,120
156,Mar 23 2019,European Championship qual in Sweden,Sweden,Romania,1831,1753,2,1,11,-11,1842,1742,16,36,1,-1,17,35,40,100,178
157,Mar 23 2019,Friendly tournament in Iraq,Syria,Jordan,1514,1513,1,0,15,-15,1529,1498,75,87,1,-4,76,83,30,0,1
158,Mar 23 2019,African Nations Cup qualifier in Zambia,Zambia,Namibia,1416,1379,4,1,22,-22,1438,1357,93,124,4,-6,97,118,40,100,137
159,Mar 24 2019,CONCACAF Nations League q in Barbados,Barbados,Nicaragua,1151,1290,0,1,-18,18,1133,1308,173,133,-2,3,171,136,40,100,-39
160,Mar 24 2019,African Nations Cup qualifier in Benin,Benin,Togo,1390,1360,2,1,13,-13,1403,1347,100,128,4,-6,104,122,40,100,130
161,Mar 24 2019,CONCACAF Nations League q in Anguilla,Bonaire,British Virgin Islands,967,652,2,1,6,-6,973,646,191,226,2,0,193,226,40,0,315
162,Mar 24 2019,CONCACAF Nations League q in Canada,Canada,French Guiana,1547,1321,4,1,9,-9,1556,1312,68,135,0,-2,68,133,40,100,326
163,Mar 24 2019,African Nations Cup qualifier in Cape Verde,Cape Verde,Lesotho,1406,1299,0,0,-11,11,1395,1310,108,131,-2,3,106,134,40,100,207
164,Mar 24 2019,African Nations Cup qualifier in Central African Republic,Central African Republic,Guinea,1332,1469,0,0,2,-2,1334,1467,126,88,0,2,126,90,30,100,-37
165,Mar 24 2019,European Championship qual in Cyprus,Cyprus,Belgium,1416,2041,0,2,-3,3,1413,2044,102,3,0,0,102,3,40,100,-525
166,Mar 24 2019,CONCACAF Nations League q in the Dominican Republic,Dominican Republic,Bermuda,1271,1181,1,3,-45,45,1226,1226,161,138,-9,14,152,152,40,100,190
167,Mar 24 2019,African Nations Cup qualifier in the Dem Rep of the Congo,DR Congo,Liberia,1546,1344,1,0,6,-6,1552,1338,69,124,0,-1,69,123,40,100,302
168,Mar 24 2019,Friendly tournament in Fiji,Fiji,Mauritius,1230,1103,1,0,6,-6,1236,1097,145,183,3,-3,148,180,20,0,127
169,Mar 24 2019,CONCACAF Nations League q in Haiti,Haiti,Cuba,1514,1341,2,1,7,-7,1521,1334,78,129,0,-3,78,126,40,100,273
170,Mar 24 2019,European Championship qual in Hungary,Hungary,Croatia,1598,1926,2,1,32,-32,1630,1894,43,14,8,-1,51,13,40,100,-228
171,Mar 24 2019,European Championship qual in Israel,Israel,Austria,1555,1738,4,2,37,-37,1592,1701,58,48,4,-6,62,42,40,100,-83
172,Mar 24 2019,European Championship qual in Kazakhstan,Kazakhstan,Russia,1398,1747,0,4,-14,14,1384,1761,110,30,-2,2,108,32,40,100,-249
173,Mar 24 2019,European Championship qual in the Netherlands,Netherlands,Germany,1989,1932,2,3,-28,28,1961,1960,9,7,-2,1,7,8,40,100,157
174,Mar 24 2019,European Championship qual in Northern Ireland,Northern Ireland,Belarus,1634,1535,2,1,10,-10,1644,1525,48,82,1,-5,49,77,40,100,199
175,Mar 24 2019,European Championship qual in Poland,Poland,Latvia,1778,1290,2,0,2,-2,1780,1288,24,141,0,-1,24,140,20,0,488
176,Mar 24 2019,CONCACAF Nations League q in Puerto Rico,Puerto Rico,Grenada,1008,1080,0,2,-32,32,976,1112,195,170,-3,6,192,176,40,100,28
177,Mar 24 2019,European Championship qual in San Marino,San Marino,Scotland,833,1664,0,2,-1,1,832,1665,204,47,0,0,204,47,30,100,-731
178,Mar 24 2019,European Championship qual in Slovenia,Slovenia,North Macedonia,1567,1527,1,1,-8,8,1559,1535,70,67,-3,5,67,72,40,100,140
179,Mar 24 2019,African Nations Cup qualifier in Tunisia,South Africa,Libya,1551,1476,2,1,16,-16,1567,1460,63,96,2,-4,65,92,40,0,75
180,Mar 24 2019,Friendly in Taiwan,Taiwan,Solomon Islands,977,1218,0,1,-6,6,971,1224,195,152,-1,2,194,154,20,100,-141
181,Mar 24 2019,African Nations Cup qualifier in Tanzania,Tanzania,Uganda,1328,1476,3,0,40,-40,1368,1436,100,106,14,-9,114,97,40,100,-48
182,Mar 24 2019,European Championship qual in Wales,Wales,Slovakia,1762,1760,1,0,14,-14,1776,1746,21,36,5,-2,26,34,40,100,102
183,Mar 24 2019,African Nations Cup qualifier in Zimbabwe,Zimbabwe,Congo,1474,1391,2,0,16,-16,1490,1375,83,115,4,-4,87,111,40,100,183
184,Mar 25 2019,European Championship qual in Andorra,Andorra,Albania,1077,1491,0,3,-10,10,1067,1501,186,76,-1,5,185,81,40,100,-314
185,Mar 25 2019,Friendly in Azerbaijan,Azerbaijan,Lithuania,1402,1324,0,0,-5,5,1397,1329,105,129,0,0,105,129,20,100,178
186,Mar 25 2019,Friendly tournament in China,China,Uzbekistan,1496,1605,0,1,-15,15,1481,1620,92,48,-4,5,88,53,30,100,-9
187,Mar 25 2019,European Championship qual in France,France,Iceland,2095,1670,4,0,3,-3,2098,1667,2,46,0,0,2,46,20,0,425
188,Mar 25 2019,European Championship qual in Kosovo,Kosovo,Bulgaria,1502,1621,1,1,1,-1,1503,1620,78,53,1,0,79,53,20,100,-19
189,Mar 25 2019,Friendly in Kuwait,Kuwait,Nepal,1424,886,1,0,0,0,1424,886,99,201,0,0,99,201,20,100,638
190,Mar 25 2019,European Championship qual in Luxembourg,Luxembourg,Ukraine,1361,1787,1,2,-5,5,1356,1792,121,21,-3,1,118,22,40,100,-326
191,Mar 25 2019,European Championship qual in Montenegro,Montenegro,England,1597,1970,1,5,-13,13,1584,1983,66,5,-3,0,63,5,40,100,-273
192,Mar 25 2019,Friendly in Myanmar,Myanmar,Indonesia,1052,1198,0,2,-13,13,1039,1211,188,157,-1,2,187,159,20,100,-46
193,Mar 25 2019,European Championship qual in Portugal,Portugal,Serbia,1946,1813,1,1,-12,12,1934,1825,9,19,0,0,9,19,40,100,233
194,Mar 25 2019,Friendly in Saudi Arabia,Saudi Arabia,Equatorial Guinea,1563,1338,3,2,3,-3,1566,1335,66,127,0,-2,66,125,20,100,325
195,Mar 25 2019,European Championship qual in Turkey,Turkey,Moldova,1715,1313,4,0,4,-4,1719,1309,34,138,2,-3,36,135,40,100,502
196,Mar 25 2019,Friendly tournament in China,Uruguay,Thailand,1931,1371,4,0,2,-2,1933,1369,9,113,1,0,10,113,30,0,560
197,Mar 26 2019,Friendly in Algeria,Algeria,Tunisia,1530,1652,1,0,11,-11,1541,1641,65,50,5,-1,70,49,20,100,-22
198,Mar 26 2019,European Championship qual in Armenia,Armenia,Finland,1446,1616,0,2,-24,24,1422,1640,106,44,-6,6,100,50,40,100,-70
199,Mar 26 2019,European Championship qual in Bosnia and Herzegovina,Bosnia and Herzegovina,Greece,1798,1619,2,2,-13,13,1785,1632,25,51,-2,2,23,53,40,100,279
200,Mar 26 2019,Friendly in Costa Rica,Costa Rica,Jamaica,1700,1540,1,0,4,-4,1704,1536,41,72,1,-1,42,71,20,100,260
201,Mar 26 2019,Friendly in Czechia,Czechia,Brazil,1719,2128,1,3,-4,4,1715,2132,40,1,-2,0,38,1,20,100,-309
202,Mar 26 2019,Friendly in the United States,Ecuador,Honduras,1764,1591,0,0,-5,5,1759,1596,35,60,-2,1,33,61,20,0,173
203,Mar 26 2019,Friendly in the United States,El Salvador,Peru,1501,1861,2,0,27,-27,1528,1834,73,18,4,-1,77,17,20,0,-360
204,Mar 26 2019,Friendly in Ghana,Ghana,Mauritania,1630,1349,3,1,3,-3,1633,1346,53,124,-1,-2,52,122,20,100,381
205,Mar 26 2019,Friendly in Gibraltar,Gibraltar,Estonia,1102,1476,0,1,-3,3,1099,1479,178,89,0,0,178,89,20,100,-274
206,Mar 26 2019,Friendly tournament in Iraq,Iraq,Jordan,1596,1498,3,2,7,-7,1603,1491,56,86,2,-1,58,85,20,0,98
207,Mar 26 2019,European Championship qual in Ireland,Ireland,Georgia,1706,1536,1,0,7,-7,1713,1529,37,81,2,-5,39,76,40,100,270
208,Mar 26 2019,European Championship qual in Italy,Italy,Liechtenstein,1895,1132,6,0,1,-1,1896,1131,16,172,-2,0,14,172,20,0,763
209,Mar 26 2019,Friendly in Ivory Coast,Ivory Coast,Liberia,1610,1338,1,0,2,-2,1612,1336,57,125,0,-1,57,124,20,100,372
210,Mar 26 2019,Friendly in Japan,Japan,Bolivia,1773,1642,1,0,4,-4,1777,1638,24,52,2,-1,26,51,20,100,231
211,Mar 26 2019,European Championship qual in Malta,Malta,Spain,1197,2014,0,2,-1,1,1196,2015,163,4,0,0,163,4,30,100,-717
212,Mar 26 2019,Friendly in the United States,Mexico,Paraguay,1805,1719,4,2,11,-11,1816,1708,20,44,0,-4,20,40,20,0,86
213,Mar 26 2019,Friendly in Morocco,Morocco,Argentina,1714,1894,0,1,-8,8,1706,1902,43,11,-2,1,41,12,20,100,-80
214,Mar 26 2019,Friendly in Nicaragua,Nicaragua,Guatemala,1308,1492,0,1,-8,8,1300,1500,140,81,-2,2,138,83,20,100,-84
215,Mar 26 2019,Friendly in Nigeria,Nigeria,Egypt,1713,1606,1,0,5,-5,1718,1601,34,60,3,-1,37,59,20,100,207
216,Mar 26 2019,European Championship qual in Norway,Norway,Sweden,1675,1842,3,3,4,-4,1679,1838,43,15,1,1,44,16,20,0,-167
217,Mar 26 2019,European Championship qual in Romania,Romania,Faroe Islands,1742,1236,4,1,2,-2,1744,1234,35,152,0,-2,35,150,20,0,506
218,Mar 26 2019,Friendly in Senegal,Senegal,Mali,1760,1533,2,1,3,-3,1763,1530,29,77,2,-2,31,75,20,100,327
219,Mar 26 2019,Friendly in South Korea,South Korea,Colombia,1771,1969,2,1,13,-13,1784,1956,19,10,5,-2,24,8,20,100,-98
220,Mar 26 2019,European Championship qual in Switzerland,Switzerland,Denmark,1932,1891,3,3,-8,8,1924,1899,11,11,0,2,11,13,40,100,141
221,Mar 26 2019,Friendly in the United Arab Emirates,United Arab Emirates,Syria,1485,1529,0,0,-2,2,1483,1531,87,72,0,2,87,74,20,100,56
222,Mar 26 2019,Friendly in the United States,United States,Chile,1767,1833,1,1,-1,1,1766,1834,30,16,0,1,30,17,20,100,34
223,May 25 2019,COSAFA Cup in South Africa,Mauritius,Eswatini,1097,1202,2,2,6,-6,1103,1196,176,163,2,-1,178,162,40,0,-105
224,May 26 2019,COSAFA Cup in South Africa,Malawi,Seychelles,1268,969,3,0,11,-11,1279,958,143,197,0,-1,143,196,40,0,299
225,May 26 2019,COSAFA Cup in South Africa,Namibia,Mozambique,1357,1304,2,1,17,-17,1374,1287,107,145,5,-4,112,141,40,0,53
226,May 27 2019,COSAFA Cup in South Africa,Comoros,Eswatini,1086,1196,2,2,6,-6,1092,1190,180,166,1,-2,181,164,40,0,-110
227,May 28 2019,Friendly in Laos,Laos,Sri Lanka,693,706,2,1,8,-8,701,698,216,222,2,-2,218,220,20,100,87
228,May 28 2019,COSAFA Cup in South Africa,Malawi,Namibia,1279,1374,2,1,25,-25,1304,1349,131,126,6,-7,137,119,40,0,-95
229,May 28 2019,COSAFA Cup in South Africa,Mozambique,Seychelles,1287,958,0,0,-15,15,1272,973,145,190,-2,3,143,193,40,0,329
230,May 29 2019,Friendly in the Cayman Islands,Cayman Islands,Cuba,910,1334,0,0,7,-7,917,1327,199,132,0,-3,199,129,20,100,-324
231,May 29 2019,COSAFA Cup in South Africa,Comoros,Mauritius,1092,1103,2,1,21,-21,1113,1082,171,186,5,-4,176,182,40,0,-11
232,May 30 2019,COSAFA Cup in South Africa,Malawi,Mozambique,1304,1272,1,1,-2,2,1302,1274,137,143,0,0,137,143,40,0,32
233,May 30 2019,COSAFA Cup in South Africa,Namibia,Seychelles,1349,973,3,0,7,-7,1356,966,115,197,2,-2,117,195,40,0,376
234,May 30 2019,Friendly in Turkey,Turkey,Greece,1719,1632,2,1,5,-5,1724,1627,36,55,0,-1,36,54,20,100,187
235,May 31 2019,Friendly in the Cayman Islands,Cayman Islands,Cuba,917,1327,0,1,-3,3,914,1330,199,125,0,2,199,127,20,100,-310
236,May 31 2019,Friendly in Laos,Laos,Sri Lanka,701,698,2,2,-3,3,698,701,222,216,-2,2,220,218,20,100,103
237,Jun 1 2019,Friendly in the United States,Ecuador,Venezuela,1759,1777,1,1,1,-1,1760,1776,33,28,0,-1,33,27,20,0,-18
238,Jun 1 2019,COSAFA Cup in South Africa,Lesotho,Uganda,1310,1436,0,0,7,-7,1317,1429,131,98,1,-1,132,97,40,0,-126
239,Jun 1 2019,COSAFA Cup in South Africa,Zimbabwe,Comoros,1490,1113,2,0,6,-6,1496,1107,84,180,1,-2,85,178,40,0,377
240,Jun 2 2019,Friendly in the United States,El Salvador,Haiti,1528,1521,1,0,10,-10,1538,1511,65,79,6,0,71,79,20,0,7
241,Jun 2 2019,Friendly in France,France,Bolivia,2098,1638,2,0,1,-1,2099,1637,2,51,0,0,2,51,20,100,560
242,Jun 2 2019,Friendly in Luxembourg,Luxembourg,Madagascar,1356,1338,3,3,-3,3,1353,1341,119,123,-1,0,118,123,20,100,118
243,Jun 2 2019,COSAFA Cup in South Africa,Malawi,Zambia,1302,1438,2,2,7,-7,1309,1431,133,97,2,-1,135,96,40,0,-136
244,Jun 2 2019,Friendly in Malaysia,Malaysia,Nepal,1118,886,2,0,4,-4,1122,882,175,201,0,0,175,201,20,100,332
245,Jun 2 2019,COSAFA Cup in South Africa,South Africa,Botswana,1567,1288,2,2,-16,16,1551,1304,73,136,-4,2,69,138,40,100,379
246,Jun 2 2019,Friendly in Turkey,Turkey,Uzbekistan,1724,1620,2,0,7,-7,1731,1613,36,57,0,-1,36,56,20,100,204
247,Jun 3 2019,Friendly in Colombia,Colombia,Panama,1956,1571,3,0,2,-2,1958,1569,8,64,0,0,8,64,20,100,485
248,Jun 4 2019,COSAFA Cup in South Africa,Malawi,Comoros,1309,1107,2,1,10,-10,1319,1097,129,182,3,-2,132,180,40,0,202
249,Jun 4 2019,COSAFA Cup in South Africa,South Africa,Uganda,1551,1429,1,1,-11,11,1540,1440,71,93,-1,2,70,95,40,100,222
250,Jun 4 2019,Friendly tournament in Vanuatu,Vanuatu,Tahiti,1198,1224,2,0,18,-18,1216,1206,153,168,4,-7,157,161,30,100,74
251,Jun 5 2019,COSAFA Cup in South Africa,Botswana,Lesotho,1304,1317,2,1,21,-21,1325,1296,124,145,7,-6,131,139,40,0,-13
252,Jun 5 2019,Friendly in Brazil,Brazil,Qatar,2132,1774,2,0,2,-2,2134,1772,1,25,0,2,1,27,20,100,458
253,Jun 5 2019,King's Cup in Thailand,CuraÃ§ao,India,1310,1253,3,1,19,-19,1329,1234,123,151,6,-2,129,149,30,0,57
254,Jun 5 2019,Friendly in Japan,Japan,Trinidad and Tobago,1777,1432,0,0,-9,9,1768,1441,30,94,-2,1,28,95,20,100,445
255,Jun 5 2019,Friendly in the United States,Mexico,Venezuela,1816,1776,3,1,13,-13,1829,1763,18,31,1,-2,19,29,20,0,40
256,Jun 5 2019,Friendly in Paraguay,Paraguay,Honduras,1708,1596,1,1,-5,5,1703,1601,42,57,-1,2,41,59,20,100,212
257,Jun 5 2019,Friendly in Peru,Peru,Costa Rica,1834,1704,1,0,4,-4,1838,1700,15,44,1,-1,16,43,20,100,230
258,Jun 5 2019,European Nations League in Portugal,Portugal,Switzerland,1934,1924,3,1,26,-26,1960,1898,5,15,2,-2,7,13,50,100,110
259,Jun 5 2019,King's Cup in Thailand,Thailand,Vietnam,1369,1352,0,1,-20,20,1349,1372,125,105,-6,7,119,112,30,100,117
260,Jun 5 2019,Friendly in the United States,United States,Jamaica,1766,1536,0,1,-17,17,1749,1553,36,64,-3,4,33,68,20,100,330
261,Jun 5 2019,COSAFA Cup in South Africa,Zambia,Zimbabwe,1431,1496,0,0,4,-4,1435,1492,97,85,0,0,97,85,40,0,-65
262,Jun 6 2019,Friendly in Bermuda,Bermuda,Guyana,1226,1190,1,0,6,-6,1232,1184,150,168,1,-2,151,166,20,100,136
263,Jun 6 2019,World Cup & Asian Cup qual in Bhutan,Bhutan,Guam,556,794,1,0,28,-28,584,766,227,217,3,-5,230,212,40,100,-138
264,Jun 6 2019,World Cup & Asian Cup qual in Cambodia,Cambodia,Pakistan,779,933,2,0,35,-35,814,898,203,203,4,-3,207,200,40,100,-54
265,Jun 6 2019,Friendly in Chile,Chile,Haiti,1834,1511,2,1,2,-2,1836,1509,18,79,0,0,18,79,20,100,423
266,Jun 6 2019,Friendly in Iran,Iran,Syria,1789,1531,5,0,5,-5,1794,1526,20,79,1,-2,21,77,20,100,358
267,Jun 6 2019,World Cup & Asian Cup qual in Laos,Laos,Bangladesh,698,804,0,1,-20,20,678,824,228,206,-4,0,224,206,40,100,-6
268,Jun 6 2019,World Cup & Asian Cup qual in China,Macao,Sri Lanka,674,701,1,0,22,-22,696,679,213,228,6,-5,219,223,40,0,-27
269,Jun 6 2019,World Cup & Asian Cup qual in Mongolia,Mongolia,Brunei,707,613,2,0,15,-15,722,598,215,229,1,0,216,229,40,100,194
270,Jun 6 2019,European Nations League in Portugal,Netherlands,England,1961,1983,3,1,40,-40,2001,1943,4,13,1,-4,5,9,50,0,-22
271,Jun 6 2019,Friendly in Taiwan,Taiwan,Nepal,971,882,1,1,-5,5,966,887,194,201,0,0,194,201,20,100,189
272,Jun 7 2019,Friendly in Argentina,Argentina,Nicaragua,1902,1300,5,1,1,-1,1903,1299,11,140,0,-1,11,139,20,0,602
273,Jun 7 2019,European Championship qual in Austria,Austria,Slovenia,1701,1559,1,0,8,-8,1709,1551,38,72,2,-3,40,69,40,100,242
274,Jun 7 2019,Friendly in China,China,Philippines,1481,1134,2,0,2,-2,1483,1132,84,174,2,-2,86,172,20,100,447
275,Jun 7 2019,European Championship qual in Czechia,Czechia,Bulgaria,1715,1620,2,1,10,-10,1725,1610,38,59,0,-2,38,57,40,100,195
276,Jun 7 2019,European Championship qual in Denmark,Denmark,Ireland,1899,1713,1,1,-14,14,1885,1727,18,35,-3,2,15,37,40,100,286
277,Jun 7 2019,European Championship qual in the Faroe Islands,Faroe Islands,Spain,1234,2015,1,4,-1,1,1233,2016,151,4,-1,0,150,4,20,100,-681
278,Jun 7 2019,Friendly tournament in Vanuatu,Fiji,Tahiti,1236,1206,1,1,-1,1,1235,1207,147,159,0,1,147,160,20,0,30
279,Jun 7 2019,Friendly in Morocco,Gambia,Guinea,1321,1467,1,0,14,-14,1335,1453,115,96,9,-3,124,93,20,0,-146
280,Jun 7 2019,European Championship qual in Georgia,Georgia,Gibraltar,1529,1099,3,0,3,-3,1532,1096,70,180,3,-1,73,179,20,0,430
281,Jun 7 2019,Friendly in France,Ivory Coast,Comoros,1612,1097,3,1,1,-1,1613,1096,55,178,1,1,56,179,20,0,515
282,Jun 7 2019,Friendly in France,Kenya,Madagascar,1383,1341,1,0,9,-9,1392,1332,105,133,2,-5,107,128,20,0,42
283,Jun 7 2019,European Championship qual in Latvia,Latvia,Israel,1288,1592,0,3,-17,17,1271,1609,145,54,-2,4,143,58,40,100,-204
284,Jun 7 2019,COSAFA Cup in South Africa,Lesotho,Zimbabwe,1296,1492,2,2,10,-10,1306,1482,137,91,1,-3,138,88,40,0,-196
285,Jun 7 2019,European Championship qual in Lithuania,Lithuania,Luxembourg,1329,1353,1,1,-4,4,1325,1357,135,116,-3,1,132,117,40,100,76
286,Jun 7 2019,World Cup qualifier in Malaysia,Malaysia,East Timor,1122,643,7,1,3,-3,1125,640,173,227,1,0,174,227,20,0,479
287,Jun 7 2019,European Championship qual in Montenegro,Montenegro,Kosovo,1584,1503,1,1,-10,10,1574,1513,63,78,0,1,63,79,40,100,181
288,Jun 7 2019,European Championship qual in North Macedonia,North Macedonia,Poland,1535,1780,0,1,-12,12,1523,1792,83,21,-5,2,78,23,40,100,-145
289,Jun 7 2019,European Championship qual in Norway,Norway,Romania,1679,1744,2,2,-2,2,1677,1746,44,35,0,0,44,35,30,100,35
290,Jun 7 2019,Friendly in Slovakia,Slovakia,Jordan,1746,1491,5,1,4,-4,1750,1487,32,84,1,1,33,85,20,100,355
291,Jun 7 2019,COSAFA Cup in South Africa,South Africa,Malawi,1540,1319,0,0,-15,15,1525,1334,81,118,-5,8,76,126,40,100,321
292,Jun 7 2019,Friendly in South Korea,South Korea,Australia,1784,1678,1,0,5,-5,1789,1673,24,45,0,0,24,45,20,100,206
293,Jun 7 2019,European Championship qual in Sweden,Sweden,Malta,1838,1196,3,0,1,-1,1839,1195,16,162,0,0,16,162,20,0,642
294,Jun 7 2019,Friendly in Tajikistan,Tajikistan,Afghanistan,1209,1130,1,1,-5,5,1204,1135,162,167,-1,3,161,170,20,100,179
295,Jun 7 2019,Friendly in Tunisia,Tunisia,Iraq,1641,1603,2,0,9,-9,1650,1594,47,66,1,-4,48,62,20,100,138
296,Jun 7 2019,European Championship qual in Ukraine,Ukraine,Serbia,1792,1825,5,0,32,-32,1824,1793,18,24,2,-2,20,22,40,100,67
297,Jun 7 2019,Friendly in Uruguay,Uruguay,Panama,1933,1569,3,0,2,-2,1935,1567,10,64,0,0,10,64,20,100,464
298,Jun 7 2019,Friendly in Uzbekistan,Uzbekistan,North Korea,1613,1330,4,0,4,-4,1617,1326,54,135,1,-4,55,131,20,100,383
299,Jun 8 2019,Friendly in Portugal,Angola,Guinea-Bissau,1349,1308,2,0,13,-13,1362,1295,111,141,4,-2,115,139,20,0,41
300,Jun 8 2019,European Championship qual in Armenia,Armenia,Liechtenstein,1422,1131,3,0,7,-7,1429,1124,96,175,2,-1,98,174,40,100,391
301,Jun 8 2019,European Championship qual in Azerbaijan,Azerbaijan,Hungary,1397,1630,1,3,-19,19,1378,1649,115,49,-5,2,110,51,40,100,-133
302,Jun 8 2019,European Championship qual in Belarus,Belarus,Germany,1525,1960,0,2,-8,8,1517,1968,80,6,-2,0,78,6,40,100,-335
303,Jun 8 2019,European Championship qual in Belgium,Belgium,Kazakhstan,2044,1384,3,0,1,-1,2045,1383,3,107,0,1,3,108,20,0,660
304,Jun 8 2019,European Championship qual in Croatia,Croatia,Wales,1894,1776,2,1,9,-9,1903,1767,10,30,2,-2,12,28,40,100,218
305,Jun 8 2019,King's Cup in Thailand,CuraÃ§ao,Vietnam,1329,1372,1,1,2,-2,1331,1370,126,114,2,-1,128,113,30,0,-43
306,Jun 8 2019,European Championship qual in Estonia,Estonia,Northern Ireland,1479,1644,1,2,-16,16,1463,1660,89,49,0,0,89,49,40,100,-65
307,Jun 8 2019,European Championship qual in Finland,Finland,Bosnia and Herzegovina,1640,1785,2,0,34,-34,1674,1751,40,41,5,-8,45,33,40,100,-45
308,Jun 8 2019,European Championship qual in Greece,Greece,Italy,1627,1896,0,3,-19,19,1608,1915,62,9,-4,2,58,11,40,100,-169
309,Jun 8 2019,European Championship qual in Iceland,Iceland,Albania,1667,1501,1,0,7,-7,1674,1494,44,86,1,-2,45,84,40,100,266
310,Jun 8 2019,European Championship qual in Moldova,Moldova,Andorra,1309,1067,1,0,5,-5,1314,1062,132,185,2,0,134,185,40,100,342
311,Jun 8 2019,Friendly in Nigeria,Nigeria,Zimbabwe,1718,1482,0,0,-7,7,1711,1489,39,82,0,3,39,85,20,100,336
312,Jun 8 2019,European Championship qual in Russia,Russia,San Marino,1761,832,9,0,0,0,1761,832,31,204,0,0,31,204,20,0,929
313,Jun 8 2019,European Championship qual in Scotland,Scotland,Cyprus,1665,1413,2,1,5,-5,1670,1408,49,104,-1,-1,48,103,40,100,352
314,Jun 8 2019,Friendly in Singapore,Singapore,Solomon Islands,1112,1224,4,3,10,-10,1122,1214,176,160,0,-3,176,157,20,100,-12
315,Jun 8 2019,King's Cup in Thailand,Thailand,India,1349,1234,0,1,-23,23,1326,1257,141,143,-11,3,130,146,30,100,215
316,Jun 8 2019,European Championship qual in Turkey,Turkey,France,1731,2099,2,0,49,-49,1780,2050,14,2,11,0,25,2,40,100,-268
317,Jun 8 2019,COSAFA Cup in South Africa,Zambia,Botswana,1435,1325,1,0,14,-14,1449,1311,91,140,3,-4,94,136,40,0,110
318,Jun 9 2019,Friendly in Brazil,Brazil,Honduras,2134,1601,7,0,1,-1,2135,1600,1,63,0,-2,1,61,20,100,633
319,Jun 9 2019,Friendly in Spain,Burkina Faso,DR Congo,1533,1552,0,0,1,-1,1534,1551,70,68,1,0,71,68,20,0,-19
320,Jun 9 2019,Friendly in Spain,Cameroon,Zambia,1601,1449,2,1,6,-6,1607,1443,59,94,0,0,59,94,20,0,152
321,Jun 9 2019,European Nations League in Portugal,England,Switzerland,1943,1898,0,0,-3,3,1940,1901,9,14,0,0,9,14,40,0,45
322,Jun 9 2019,Friendly in Japan,Japan,El Salvador,1768,1538,2,0,4,-4,1772,1534,27,71,0,0,27,71,20,100,330
323,Jun 9 2019,Friendly in the United States,Mexico,Ecuador,1829,1760,3,2,8,-8,1837,1752,15,32,2,0,17,32,20,0,69
324,Jun 9 2019,Friendly in the United Arab Emirates,Namibia,Ghana,1356,1633,1,0,17,-17,1373,1616,105,55,7,-1,112,54,20,0,-277
325,Jun 9 2019,Friendly in Paraguay,Paraguay,Guatemala,1703,1500,2,0,4,-4,1707,1496,40,84,1,-1,41,83,20,100,303
326,Jun 9 2019,Friendly in Peru,Peru,Colombia,1838,1958,0,3,-16,16,1822,1974,23,6,-3,1,20,7,20,100,-20
327,Jun 9 2019,European Nations League in Portugal,Portugal,Netherlands,1960,2001,1,0,21,-21,1981,1980,3,7,2,-1,5,6,50,100,59
328,Jun 9 2019,Friendly in the United Arab Emirates,Turkmenistan,Uganda,1221,1440,0,0,6,-6,1227,1434,150,97,2,0,152,97,20,0,-219
329,Jun 9 2019,Friendly in the United States,United States,Venezuela,1749,1763,0,3,-22,22,1727,1785,37,21,-1,4,36,25,20,100,86
330,Jun 10 2019,European Championship qual in Bulgaria,Bulgaria,Kosovo,1610,1513,2,3,-30,30,1580,1543,68,61,-6,9,62,70,40,100,197
331,Jun 10 2019,Friendly in the United States,Canada,Trinidad and Tobago,1556,1441,2,0,10,-10,1566,1431,64,98,1,-1,65,97,20,0,115
332,Jun 10 2019,European Championship qual in Czechia,Czechia,Montenegro,1725,1574,3,0,13,-13,1738,1561,34,71,2,-4,36,67,40,100,251
333,Jun 10 2019,European Championship qual in Denmark,Denmark,Georgia,1885,1532,5,1,5,-5,1890,1527,15,77,0,-2,15,75,40,100,453
334,Jun 10 2019,European Championship qual in the Faroe Islands,Faroe Islands,Norway,1233,1677,0,2,-7,7,1226,1684,156,44,-3,0,153,44,40,100,-344
335,Jun 10 2019,European Championship qual in Ireland,Ireland,Gibraltar,1727,1096,2,0,1,-1,1728,1095,40,181,-2,-1,38,180,20,0,631
336,Jun 10 2019,European Championship qual in Latvia,Latvia,Slovenia,1271,1551,0,5,-21,21,1250,1572,151,58,-4,5,147,63,40,100,-180
337,Jun 10 2019,European Championship qual in Malta,Malta,Romania,1195,1746,0,4,-5,5,1190,1751,164,31,-1,2,163,33,40,100,-451
338,Jun 10 2019,European Championship qual in North Macedonia,North Macedonia,Austria,1523,1709,1,4,-27,27,1496,1736,87,34,-5,3,82,37,40,100,-86
339,Jun 10 2019,European Championship qual in Poland,Poland,Israel,1792,1609,4,0,12,-12,1804,1597,19,63,2,-3,21,60,40,100,283
340,Jun 10 2019,European Championship qual in Serbia,Serbia,Lithuania,1793,1325,4,1,3,-3,1796,1322,22,134,0,-1,22,133,30,0,468
341,Jun 10 2019,European Championship qual in Spain,Spain,Sweden,2016,1839,3,0,12,-12,2028,1827,4,20,0,-2,4,18,40,100,277
342,Jun 10 2019,European Championship qual in Ukraine,Ukraine,Luxembourg,1824,1357,1,0,1,-1,1825,1356,19,119,0,0,19,119,20,0,467
343,Jun 10 2019,Friendly tournament in Vanuatu,Vanuatu,Fiji,1216,1235,0,0,-3,3,1213,1238,158,148,-1,0,157,148,30,100,81
344,Jun 11 2019,European Championship qual in Albania,Albania,Moldova,1494,1314,2,0,10,-10,1504,1304,74,140,5,-3,79,137,40,100,280
345,Jun 11 2019,Friendly in Qatar,Algeria,Burundi,1541,1361,1,1,-5,5,1536,1366,71,113,0,2,71,115,20,0,180
346,Jun 11 2019,European Championship qual in Andorra,Andorra,France,1062,2050,0,4,0,0,1062,2050,185,2,0,0,185,2,20,0,-988
347,Jun 11 2019,European Championship qual in Azerbaijan,Azerbaijan,Slovakia,1378,1750,1,5,-13,13,1365,1763,122,23,-6,6,116,29,40,100,-272
348,Jun 11 2019,World Cup & Asian Cup qual in Bangladesh,Bangladesh,Laos,824,678,0,0,-12,12,812,690,208,220,-1,2,207,222,40,100,246
349,Jun 11 2019,European Championship qual in Belarus,Belarus,Northern Ireland,1517,1660,0,1,-18,18,1499,1678,84,43,-3,3,81,46,40,100,-43
350,Jun 11 2019,European Championship qual in Belgium,Belgium,Scotland,2045,1670,3,0,4,-4,2049,1666,3,54,0,-3,3,51,20,0,375
351,Jun 11 2019,Friendly in Morocco,Benin,Guinea,1403,1453,1,0,11,-11,1414,1442,100,99,2,-3,102,96,20,0,-50
352,Jun 11 2019,World Cup & Asian Cup qual in Brunei,Brunei,Mongolia,598,722,2,1,21,-21,619,701,229,218,0,-1,229,217,40,100,-24
353,Jun 11 2019,World Cup & Asian Cup qual in Qatar,Cambodia,Pakistan,814,898,2,1,25,-25,839,873,201,202,3,-1,204,201,40,0,-84
354,Jun 11 2019,Friendly in China,China,Tajikistan,1483,1204,1,0,2,-2,1485,1202,87,159,0,1,87,160,20,100,379
355,Jun 11 2019,Friendly in Croatia,Croatia,Tunisia,1903,1650,1,2,-18,18,1885,1668,18,50,-3,0,15,50,20,100,353
356,Jun 11 2019,European Championship qual in Germany,Germany,Estonia,1968,1463,8,0,3,-3,1971,1460,8,93,0,-2,8,91,40,100,605
357,Jun 11 2019,European Championship qual in Greece,Greece,Armenia,1608,1429,2,3,-33,33,1575,1462,68,82,-6,8,62,90,40,100,279
358,Jun 11 2019,World Cup & Asian Cup qual in Guam,Guam,Bhutan,766,584,5,0,13,-13,779,571,210,232,1,-1,211,231,40,100,282
359,Jun 11 2019,Friendly in Costa Rica,Haiti,Guyana,1509,1184,3,1,4,-4,1513,1180,77,166,1,0,78,166,20,0,325
360,Jun 11 2019,Friendly in Hong Kong,Hong Kong,Taiwan,1212,966,0,2,-26,26,1186,992,170,188,-6,3,164,191,20,100,346
361,Jun 11 2019,European Championship qual in Hungary,Hungary,Wales,1649,1767,1,0,21,-21,1670,1746,47,39,2,-5,49,34,40,100,-18
362,Jun 11 2019,European Championship qual in Iceland,Iceland,Turkey,1674,1780,2,1,20,-20,1694,1760,43,36,1,-5,44,31,40,100,-6
363,Jun 11 2019,European Championship qual in Italy,Italy,Bosnia and Herzegovina,1915,1751,2,1,7,-7,1922,1744,11,37,0,-2,11,35,40,100,264
364,Jun 11 2019,Friendly in Jordan,Jordan,Indonesia,1487,1211,4,1,4,-4,1491,1207,84,157,1,1,85,158,20,100,376
365,Jun 11 2019,European Championship qual in Kazakhstan,Kazakhstan,San Marino,1383,832,4,0,2,-2,1385,830,108,206,0,-1,108,205,20,0,551
366,Jun 11 2019,Friendly in Kyrgyzstan,Kyrgyzstan,Palestine,1292,1388,2,2,0,0,1292,1388,140,107,0,0,140,107,20,100,4
367,Jun 11 2019,European Championship qual in Liechtenstein,Liechtenstein,Finland,1124,1674,0,2,-4,4,1120,1678,176,47,-1,-1,175,46,40,100,-450
368,Jun 11 2019,World Cup qualifier in Malaysia,Malaysia,East Timor,1125,640,5,1,2,-2,1127,638,173,227,0,0,173,227,20,0,485
369,Jun 11 2019,European Championship qual in Russia,Russia,Cyprus,1761,1408,1,0,3,-3,1764,1405,25,105,3,-1,28,104,30,0,353
370,Jun 11 2019,Friendly in Singapore,Singapore,Myanmar,1122,1039,1,2,-15,15,1107,1054,178,185,-1,1,177,186,20,100,183
371,Jun 11 2019,Friendly in South Korea,South Korea,Iran,1789,1794,1,1,-3,3,1786,1797,24,21,0,1,24,22,20,100,95
372,Jun 11 2019,Friendly in Uzbekistan,Uzbekistan,Syria,1617,1526,2,0,7,-7,1624,1519,53,78,0,-1,53,77,20,100,191
373,Jun 12 2019,Friendly in Morocco,Morocco,Gambia,1706,1335,0,1,-19,19,1687,1354,46,117,-2,3,44,120,20,100,471
374,Jun 13 2019,Friendly in Egypt,Egypt,Tanzania,1601,1368,1,0,3,-3,1604,1365,57,116,0,-1,57,115,20,100,333
375,Jun 14 2019,Copa AmÃ©rica in Brazil,Brazil,Bolivia,2135,1637,3,0,3,-3,2138,1634,1,52,0,0,1,52,30,0,498
376,Jun 14 2019,Friendly in Qatar,Cameroon,Mali,1607,1530,1,1,-2,2,1605,1532,56,74,0,0,56,74,20,0,77
377,Jun 14 2019,Friendly in Morocco,Mauritania,Madagascar,1346,1332,3,1,14,-14,1360,1318,114,139,4,-6,118,133,20,0,14
378,Jun 15 2019,CONCACAF Championship in the United States,Canada,Martinique,1566,1463,4,0,33,-33,1599,1430,51,107,7,-9,58,98,50,0,103
379,Jun 15 2019,Copa AmÃ©rica in Brazil,Colombia,Argentina,1974,1903,2,0,30,-30,2004,1873,3,18,2,-3,5,15,50,0,71
380,Jun 15 2019,Friendly in Spain,DR Congo,Kenya,1551,1392,1,1,-4,4,1547,1396,69,104,0,1,69,105,20,0,159
381,Jun 15 2019,Friendly in the United Arab Emirates,Ghana,South Africa,1616,1525,0,0,-3,3,1613,1528,54,74,0,1,54,75,20,0,91
382,Jun 15 2019,Friendly in Indonesia,Indonesia,Vanuatu,1207,1213,6,0,16,-16,1223,1197,152,163,3,-3,155,160,20,100,94
383,Jun 15 2019,CONCACAF Championship in the United States,Mexico,Cuba,1837,1330,7,0,6,-6,1843,1324,16,132,0,-2,16,130,50,0,507
384,Jun 15 2019,Copa AmÃ©rica in Brazil,Peru,Venezuela,1822,1785,0,0,-3,3,1819,1788,20,23,0,1,20,24,50,0,37
385,Jun 15 2019,Friendly in the United Arab Emirates,Uganda,Ivory Coast,1434,1613,1,0,15,-15,1449,1598,89,63,4,-4,93,59,20,0,-179
386,Jun 16 2019,Friendly in Qatar,Algeria,Mali,1536,1532,3,2,10,-10,1546,1522,69,78,1,-2,70,76,20,0,4
387,Jun 16 2019,CONCACAF Championship in Costa Rica,Costa Rica,Nicaragua,1700,1299,4,0,5,-5,1705,1294,40,140,1,-1,41,139,30,0,401
388,Jun 16 2019,Friendly in Egypt,Egypt,Guinea,1604,1442,3,1,5,-5,1609,1437,54,96,1,0,55,96,20,100,262
389,Jun 16 2019,CONCACAF Championship in Costa Rica,Haiti,Bermuda,1513,1232,2,1,8,-8,1521,1224,76,158,1,-4,77,154,50,0,281
390,Jun 16 2019,Friendly in Morocco,Morocco,Zambia,1687,1443,2,3,-18,18,1669,1461,54,86,-5,4,49,90,20,100,344
391,Jun 16 2019,Copa AmÃ©rica in Brazil,Paraguay,Qatar,1707,1772,2,2,5,-5,1712,1767,39,30,1,-2,40,28,50,0,-65
392,Jun 16 2019,Friendly in Egypt,Senegal,Nigeria,1763,1711,1,0,9,-9,1772,1702,23,44,3,-2,26,42,20,0,52
393,Jun 16 2019,Friendly in Egypt,Tanzania,Zimbabwe,1365,1489,1,1,3,-3,1368,1486,113,86,1,0,114,86,20,0,-124
394,Jun 16 2019,Copa AmÃ©rica in Brazil,Uruguay,Ecuador,1935,1752,4,0,24,-24,1959,1728,8,42,1,-5,9,37,50,0,183
395,Jun 17 2019,Copa AmÃ©rica in Brazil,Chile,Japan,1836,1772,4,0,38,-38,1874,1734,13,46,2,-10,15,36,50,0,64
396,Jun 17 2019,CONCACAF Championship in Jamaica,El Salvador,CuraÃ§ao,1534,1331,1,0,12,-12,1546,1319,68,137,2,-5,70,132,50,0,203
397,Jun 17 2019,CONCACAF Championship in Jamaica,Jamaica,Honduras,1553,1600,3,2,21,-21,1574,1579,60,67,4,-5,64,62,50,100,53
398,Jun 17 2019,Friendly in Tunisia,Tunisia,Burundi,1668,1366,2,1,2,-2,1670,1364,46,117,2,-1,48,116,20,100,402
399,Jun 18 2019,Friendly in Morocco,Benin,Mauritania,1414,1360,3,1,13,-13,1427,1347,94,124,4,-3,98,121,20,0,54
400,Jun 18 2019,Copa AmÃ©rica in Brazil,Brazil,Venezuela,2138,1788,0,0,-22,22,2116,1810,1,18,0,3,1,21,50,100,450
401,Jun 18 2019,CONCACAF Championship in the United States,Panama,Trinidad and Tobago,1567,1431,2,0,24,-24,1591,1407,56,109,5,-6,61,103,50,0,136
402,Jun 18 2019,Copa AmÃ©rica in Brazil,Peru,Bolivia,1819,1634,3,1,19,-19,1838,1615,16,54,2,-1,18,53,50,0,185
403,Jun 18 2019,CONCACAF Championship in the United States,United States,Guyana,1727,1180,4,0,2,-2,1729,1178,35,166,2,0,37,166,20,0,547
404,Jun 19 2019,Copa AmÃ©rica in Brazil,Argentina,Paraguay,1873,1712,1,1,-11,11,1862,1723,16,40,0,0,16,40,50,0,161
405,Jun 19 2019,Copa AmÃ©rica in Brazil,Colombia,Qatar,2004,1767,1,0,10,-10,2014,1757,5,33,0,-3,5,30,50,0,237
406,Jun 19 2019,Friendly in the United Arab Emirates,Ivory Coast,Zambia,1598,1461,4,1,11,-11,1609,1450,52,98,3,-4,55,94,20,0,137
407,Jun 19 2019,CONCACAF Championship in the United States,Martinique,Cuba,1430,1324,3,0,31,-31,1461,1293,83,149,7,-10,90,139,50,0,106
408,Jun 19 2019,CONCACAF Championship in the United States,Mexico,Canada,1843,1599,3,1,15,-15,1858,1584,17,65,0,-4,17,61,50,0,244
409,Jun 20 2019,CONCACAF Championship in the United States,Costa Rica,Bermuda,1705,1224,2,1,3,-3,1708,1221,41,156,0,-1,41,155,50,0,481
410,Jun 20 2019,CONCACAF Championship in the United States,Haiti,Nicaragua,1521,1294,2,0,16,-16,1537,1278,69,144,4,-3,73,141,50,0,227
411,Jun 20 2019,Copa AmÃ©rica in Brazil,Japan,Uruguay,1734,1959,2,2,14,-14,1748,1945,28,9,4,0,32,9,50,0,-225
412,Jun 21 2019,Copa AmÃ©rica in Brazil,Chile,Ecuador,1874,1728,2,1,15,-15,1889,1713,13,42,1,-2,14,40,50,0,146
413,Jun 21 2019,CONCACAF Championship in the United States,CuraÃ§ao,Honduras,1319,1579,1,0,41,-41,1360,1538,105,81,13,-9,118,72,50,0,-260
414,Jun 21 2019,African Nations Cup in Egypt,Egypt,Zimbabwe,1609,1486,1,0,11,-11,1620,1475,51,90,2,-2,53,88,50,100,223
415,Jun 21 2019,CONCACAF Championship in the United States,El Salvador,Jamaica,1546,1574,0,0,2,-2,1548,1572,66,63,2,1,68,64,40,0,-28
416,Jun 22 2019,Copa AmÃ©rica in Brazil,Brazil,Peru,2116,1838,5,0,10,-10,2126,1828,1,18,0,0,1,18,30,0,278
417,Jun 22 2019,African Nations Cup in Egypt,Guinea,Madagascar,1437,1318,2,2,-8,8,1429,1326,97,124,0,4,97,128,30,100,219
418,Jun 22 2019,African Nations Cup in Egypt,Nigeria,Burundi,1702,1364,1,0,6,-6,1708,1358,40,120,1,-2,41,118,50,0,338
419,Jun 22 2019,CONCACAF Championship in the United States,Panama,Guyana,1591,1178,4,2,6,-6,1597,1172,54,166,3,0,57,166,50,0,413
420,Jun 22 2019,African Nations Cup in Egypt,Uganda,DR Congo,1449,1547,2,0,48,-48,1497,1499,71,91,12,-11,83,80,50,0,-98
421,Jun 22 2019,CONCACAF Championship in the United States,United States,Trinidad and Tobago,1729,1407,6,0,9,-9,1738,1398,33,105,2,-1,35,104,30,0,322
422,Jun 22 2019,Copa AmÃ©rica in Brazil,Venezuela,Bolivia,1810,1615,3,1,18,-18,1828,1597,15,60,3,-3,18,57,50,0,195
423,Jun 23 2019,African Nations Cup in Egypt,Algeria,Kenya,1546,1396,2,0,22,-22,1568,1374,63,115,3,-5,66,110,50,0,150
424,Jun 23 2019,Copa AmÃ©rica in Brazil,Argentina,Qatar,1862,1757,2,0,26,-26,1888,1731,14,44,1,-7,15,37,50,0,105
425,Jun 23 2019,CONCACAF Championship in the United States,Canada,Cuba,1584,1293,7,0,18,-18,1602,1275,53,144,4,-3,57,141,50,0,291
426,Jun 23 2019,Copa AmÃ©rica in Brazil,Colombia,Paraguay,2014,1723,1,0,8,-8,2022,1715,5,39,0,0,5,39,50,0,291
427,Jun 23 2019,CONCACAF Championship in the United States,Mexico,Martinique,1858,1461,3,2,5,-5,1863,1456,17,95,0,-2,17,93,50,0,397
428,Jun 23 2019,African Nations Cup in Egypt,Morocco,Namibia,1669,1373,1,0,8,-8,1677,1365,44,115,3,-2,47,113,50,0,296
429,Jun 23 2019,African Nations Cup in Egypt,Senegal,Tanzania,1772,1368,2,0,7,-7,1779,1361,26,118,0,-2,26,116,50,0,404
430,Jun 24 2019,African Nations Cup in Egypt,Angola,Tunisia,1362,1670,1,1,18,-18,1380,1652,103,53,6,-2,109,51,50,0,-308
431,Jun 24 2019,CONCACAF Championship in the United States,Bermuda,Nicaragua,1221,1278,2,0,44,-44,1265,1234,129,160,13,-10,142,150,50,0,-57
432,Jun 24 2019,Copa AmÃ©rica in Brazil,Ecuador,Japan,1713,1748,1,1,3,-3,1716,1745,38,33,1,-1,39,32,50,0,-35
433,Jun 24 2019,CONCACAF Championship in the United States,Haiti,Costa Rica,1537,1708,2,1,36,-36,1573,1672,56,55,8,-7,64,48,50,0,-171
434,Jun 24 2019,African Nations Cup in Egypt,Ivory Coast,South Africa,1609,1528,1,0,19,-19,1628,1509,49,80,3,-3,52,77,50,0,81
435,Jun 24 2019,African Nations Cup in Egypt,Mali,Mauritania,1522,1347,4,1,23,-23,1545,1324,66,138,5,-8,71,130,50,0,175
436,Jun 24 2019,Copa AmÃ©rica in Brazil,Uruguay,Chile,1945,1889,1,0,21,-21,1966,1868,9,18,0,-2,9,16,50,0,56
437,Jun 25 2019,African Nations Cup in Egypt,Benin,Ghana,1427,1613,2,2,12,-12,1439,1601,96,59,1,-2,97,57,50,0,-186
438,Jun 25 2019,African Nations Cup in Egypt,Cameroon,Guinea-Bissau,1605,1295,2,0,11,-11,1616,1284,54,141,1,-2,55,139,50,0,310
439,Jun 25 2019,CONCACAF Championship in the United States,CuraÃ§ao,Jamaica,1360,1572,1,1,14,-14,1374,1558,105,75,6,-5,111,70,50,0,-212
440,Jun 25 2019,CONCACAF Championship in the United States,Honduras,El Salvador,1538,1548,4,0,48,-48,1586,1500,51,88,11,-9,62,79,50,0,-10
441,Jun 26 2019,African Nations Cup in Egypt,Egypt,DR Congo,1620,1499,2,0,16,-16,1636,1483,50,94,2,-7,52,87,50,100,221
442,Jun 26 2019,CONCACAF Championship in the United States,Guyana,Trinidad and Tobago,1172,1398,1,1,14,-14,1186,1384,162,110,2,-3,164,107,50,0,-226
443,Jun 26 2019,African Nations Cup in Egypt,Nigeria,Guinea,1708,1429,1,0,8,-8,1716,1421,37,102,2,-2,39,100,50,0,279
444,Jun 26 2019,African Nations Cup in Egypt,Uganda,Zimbabwe,1497,1475,1,1,-2,2,1495,1477,85,89,-1,0,84,89,50,0,22
445,Jun 26 2019,CONCACAF Championship in the United States,United States,Panama,1738,1597,1,0,10,-10,1748,1587,28,64,3,-3,31,61,50,100,241
446,Jun 27 2019,African Nations Cup in Egypt,Algeria,Senegal,1568,1779,1,0,39,-39,1607,1740,45,42,11,-8,56,34,50,0,-211
447,Jun 27 2019,Copa AmÃ©rica in Brazil,Brazil,Paraguay,2126,1715,0,0,-22,22,2104,1737,1,31,0,5,1,36,50,100,511
448,Jun 27 2019,African Nations Cup in Egypt,Kenya,Tanzania,1374,1361,3,2,24,-24,1398,1337,97,127,7,-5,104,122,50,0,13
449,Jun 27 2019,African Nations Cup in Egypt,Madagascar,Burundi,1326,1358,1,0,27,-27,1353,1331,113,136,7,-9,120,127,50,0,-32
450,Jun 28 2019,Copa AmÃ©rica in Brazil,Argentina,Venezuela,1888,1828,2,0,31,-31,1919,1797,10,26,2,-4,12,22,50,0,60
451,Jun 28 2019,Copa AmÃ©rica in Brazil,Chile,Colombia,1868,2022,0,0,10,-10,1878,2012,16,5,0,0,16,5,50,0,-154
452,Jun 28 2019,African Nations Cup in Egypt,Mali,Tunisia,1545,1652,1,1,7,-7,1552,1645,71,51,0,0,71,51,50,0,-107
453,Jun 28 2019,African Nations Cup in Egypt,Morocco,Ivory Coast,1677,1628,1,0,21,-21,1698,1607,38,57,4,-2,42,55,50,0,49
454,Jun 28 2019,African Nations Cup in Egypt,South Africa,Namibia,1509,1365,1,0,15,-15,1524,1350,74,125,1,-5,75,120,50,0,144
455,Jun 29 2019,African Nations Cup in Egypt,Angola,Mauritania,1380,1324,0,0,-4,4,1376,1328,110,126,0,2,110,128,20,100,156
456,Jun 29 2019,African Nations Cup in Egypt,Benin,Guinea-Bissau,1439,1284,0,0,-10,10,1429,1294,97,135,0,2,97,137,50,0,155
457,Jun 29 2019,African Nations Cup in Egypt,Cameroon,Ghana,1616,1601,0,0,-1,1,1615,1602,54,56,0,1,54,57,30,0,15
458,Jun 29 2019,CONCACAF Championship in the United States,Costa Rica,Mexico,1672,1863,1,1,13,-13,1685,1850,40,17,4,0,44,17,50,0,-191
459,Jun 29 2019,CONCACAF Championship in the United States,Haiti,Canada,1573,1602,3,2,27,-27,1600,1575,50,73,8,-8,58,65,50,0,-29
460,Jun 29 2019,Copa AmÃ©rica in Brazil,Peru,Uruguay,1828,1966,0,0,9,-9,1837,1957,18,9,0,0,18,9,50,0,-138
461,Jun 30 2019,African Nations Cup in Egypt,DR Congo,Zimbabwe,1483,1477,4,0,46,-46,1529,1431,61,105,13,-8,74,97,50,0,6
462,Jun 30 2019,African Nations Cup in Egypt,Egypt,Uganda,1636,1495,2,0,15,-15,1651,1480,48,92,2,-4,50,88,50,100,241
463,Jun 30 2019,African Nations Cup in Egypt,Guinea,Burundi,1421,1331,2,0,28,-28,1449,1303,90,145,5,-9,95,136,50,0,90
464,Jun 30 2019,CONCACAF Championship in the United States,Jamaica,Panama,1558,1587,1,0,27,-27,1585,1560,56,78,7,-8,63,70,50,0,-29
465,Jun 30 2019,African Nations Cup in Egypt,Madagascar,Nigeria,1353,1716,2,0,67,-67,1420,1649,83,62,18,-11,101,51,50,0,-363
466,Jun 30 2019,CONCACAF Championship in the United States,United States,CuraÃ§ao,1748,1374,1,0,3,-3,1751,1371,28,116,1,-2,29,114,30,0,374
467,Jul 1 2019,African Nations Cup in Egypt,Algeria,Tanzania,1607,1337,3,0,15,-15,1622,1322,55,138,0,-8,55,130,50,0,270
468,Jul 1 2019,African Nations Cup in Egypt,Ivory Coast,Namibia,1607,1350,4,1,16,-16,1623,1334,53,126,1,-3,54,123,50,0,257
469,Jul 1 2019,African Nations Cup in Egypt,Morocco,South Africa,1698,1524,1,0,13,-13,1711,1511,41,78,0,-1,41,77,50,0,174
470,Jul 1 2019,African Nations Cup in Egypt,Senegal,Kenya,1740,1398,3,0,11,-11,1751,1387,24,109,5,-2,29,107,50,0,342
471,Jul 2 2019,African Nations Cup in Egypt,Benin,Cameroon,1429,1615,0,0,12,-12,1441,1603,96,58,1,-1,97,57,50,0,-186
472,Jul 2 2019,Copa AmÃ©rica in Brazil,Brazil,Argentina,2104,1919,2,0,12,-12,2116,1907,1,12,0,0,1,12,30,0,185
473,Jul 2 2019,African Nations Cup in Egypt,Ghana,Guinea-Bissau,1602,1294,2,0,11,-11,1613,1283,55,141,1,-2,56,139,50,0,308
474,Jul 2 2019,African Nations Cup in Egypt,Mali,Angola,1552,1376,1,0,13,-13,1565,1363,67,121,2,-5,69,116,50,0,176
475,Jul 2 2019,African Nations Cup in Egypt,Mauritania,Tunisia,1328,1645,0,0,18,-18,1346,1627,116,52,5,0,121,52,50,0,-317
476,Jul 2 2019,CONCACAF Championship in the United States,Mexico,Haiti,1850,1600,1,0,10,-10,1860,1590,17,64,0,-3,17,61,50,0,250
477,Jul 3 2019,Copa AmÃ©rica in Brazil,Peru,Chile,1837,1878,3,0,49,-49,1886,1829,12,20,3,-2,15,18,50,0,-41
478,Jul 3 2019,CONCACAF Championship in the United States,United States,Jamaica,1751,1585,3,1,13,-13,1764,1572,23,69,3,-3,26,66,50,100,266
479,Jul 5 2019,African Nations Cup in Egypt,Benin,Morocco,1441,1711,1,1,16,-16,1457,1695,87,41,5,0,92,41,50,0,-270
480,Jul 5 2019,African Nations Cup in Egypt,Senegal,Uganda,1751,1480,1,0,9,-9,1760,1471,28,88,1,0,29,88,50,0,271
481,Jul 6 2019,Copa AmÃ©rica in Brazil,Argentina,Chile,1907,1829,2,1,19,-19,1926,1810,10,22,1,-2,11,20,50,0,78
482,Jul 6 2019,African Nations Cup in Egypt,Egypt,South Africa,1651,1511,0,1,-40,40,1611,1551,62,67,-6,5,56,72,50,100,240
483,Jul 6 2019,African Nations Cup in Egypt,Nigeria,Cameroon,1649,1603,3,2,22,-22,1671,1581,45,67,3,-5,48,62,50,0,46
484,Jul 7 2019,African Nations Cup in Egypt,Algeria,Guinea,1622,1449,3,0,24,-24,1646,1425,48,102,3,-3,51,99,50,0,173
485,Jul 7 2019,Copa AmÃ©rica in Brazil,Brazil,Peru,2116,1886,3,1,10,-10,2126,1876,1,19,0,-2,1,17,50,100,330
486,Jul 7 2019,African Nations Cup in Egypt,DR Congo,Madagascar,1529,1420,2,2,-8,8,1521,1428,77,95,-1,3,76,98,30,100,209
487,Jul 7 2019,Friendly tournament in India,India,Tajikistan,1257,1202,2,4,-32,32,1225,1234,165,139,-10,10,155,149,30,100,155
488,Jul 7 2019,CONCACAF Championship in the United States,United States,Mexico,1764,1860,0,1,-25,25,1739,1885,42,13,-8,2,34,15,50,100,4
489,Jul 8 2019,Pacific Games in Samoa,Fiji,Tahiti,1238,1207,2,1,18,-18,1256,1189,143,167,2,-4,145,163,40,0,31
490,Jul 8 2019,African Nations Cup in Egypt,Ghana,Tunisia,1613,1627,1,1,1,-1,1614,1626,55,54,0,-1,55,53,30,0,-14
491,Jul 8 2019,African Nations Cup in Egypt,Ivory Coast,Mali,1623,1565,1,0,21,-21,1644,1544,50,75,2,-3,52,72,50,0,58
492,Jul 8 2019,Pacific Games in Samoa,New Caledonia,Eastern Samoa,1172,464,5,0,1,-1,1173,463,167,237,0,0,167,237,20,0,708
493,Jul 8 2019,Pacific Games in Samoa,Samoa,Papua New Guinea,693,1092,0,6,-13,13,680,1105,226,175,-3,3,223,178,40,100,-299
494,Jul 8 2019,Pacific Games in Samoa,Solomon Islands,Tuvalu,1214,780,13,0,9,-9,1223,771,154,214,2,-2,156,212,40,0,434
495,Jul 8 2019,Friendly tournament in India,Syria,North Korea,1519,1326,5,2,13,-13,1532,1313,73,135,2,-4,75,131,30,0,193
496,Jul 10 2019,Pacific Games in Samoa,Fiji,Eastern Samoa,1256,463,9,0,1,-1,1257,462,147,237,-1,0,146,237,20,0,793
497,Jul 10 2019,Pacific Games in Samoa,New Caledonia,Solomon Islands,1173,1223,2,0,34,-34,1207,1189,149,170,9,-7,158,163,40,0,-50
498,Jul 10 2019,African Nations Cup in Egypt,Nigeria,South Africa,1671,1551,2,1,17,-17,1688,1534,38,75,5,-2,43,73,50,0,120
499,Jul 10 2019,Pacific Games in Samoa,Papua New Guinea,Vanuatu,1105,1197,2,0,38,-38,1143,1159,160,175,9,-8,169,167,40,0,-92
500,Jul 10 2019,African Nations Cup in Egypt,Senegal,Benin,1760,1457,1,0,7,-7,1767,1450,24,96,2,-2,26,94,50,0,303
501,Jul 10 2019,Pacific Games in Samoa,Tahiti,Tuvalu,1189,771,7,0,7,-7,1196,764,155,212,4,0,159,212,40,0,418
502,Jul 10 2019,Friendly tournament in India,Tajikistan,Syria,1234,1532,2,0,38,-38,1272,1494,135,93,7,-9,142,84,30,0,-298
503,Jul 11 2019,African Nations Cup in Egypt,Algeria,Ivory Coast,1646,1644,1,1,0,0,1646,1644,53,54,-1,-1,52,53,20,0,2
504,Jul 11 2019,African Nations Cup in Egypt,Tunisia,Madagascar,1626,1428,3,0,21,-21,1647,1407,49,108,2,-5,51,103,50,0,198
505,Jul 12 2019,Pacific Games in Samoa,Eastern Samoa,Tuvalu,462,764,1,1,14,-14,476,750,237,216,0,-2,237,214,40,0,-302
506,Jul 12 2019,Pacific Games in Samoa,New Caledonia,Fiji,1207,1257,1,0,23,-23,1230,1234,144,152,7,-3,151,149,40,0,-50
507,Jul 12 2019,Pacific Games in Samoa,Samoa,Tonga,680,547,2,0,12,-12,692,535,217,236,3,-1,220,235,40,100,233
508,Jul 12 2019,Pacific Games in Samoa,Tahiti,Solomon Islands,1196,1189,3,0,34,-34,1230,1155,143,171,8,-4,151,167,40,0,7
509,Jul 13 2019,Friendly tournament in India,India,North Korea,1225,1313,2,5,-27,27,1198,1340,161,113,-2,9,159,122,30,100,12
510,Jul 14 2019,African Nations Cup in Egypt,Algeria,Nigeria,1646,1688,2,1,28,-28,1674,1660,42,59,5,-8,47,51,50,0,-42
511,Jul 14 2019,African Nations Cup in Egypt,Senegal,Tunisia,1767,1647,1,0,17,-17,1784,1630,26,55,0,-2,26,53,50,0,120
512,Jul 15 2019,Pacific Games in Samoa,Fiji,Tuvalu,1234,750,10,1,6,-6,1240,744,149,216,0,-1,149,215,40,0,484
513,Jul 15 2019,Pacific Games in Samoa,New Caledonia,Tahiti,1230,1230,3,0,35,-35,1265,1195,133,167,9,-8,142,159,40,0,0
514,Jul 15 2019,Friendly tournament in India,North Korea,Tajikistan,1340,1272,1,0,12,-12,1352,1260,118,150,2,-4,120,146,30,0,68
515,Jul 15 2019,Pacific Games in Samoa,Solomon Islands,Eastern Samoa,1155,476,13,0,2,-2,1157,474,167,237,0,0,167,237,30,0,679
516,Jul 15 2019,Pacific Games in Samoa,Vanuatu,Tonga,1159,535,14,0,3,-3,1162,532,166,235,0,0,166,235,30,0,624
517,Jul 16 2019,Friendly tournament in India,India,Syria,1198,1494,1,1,8,-8,1206,1486,158,86,0,-1,158,85,30,100,-196
518,Jul 17 2019,African Nations Cup in Egypt,Nigeria,Tunisia,1660,1630,1,0,23,-23,1683,1607,39,59,6,-3,45,56,50,0,30
519,Jul 18 2019,Pacific Games in Samoa,Fiji,Solomon Islands,1240,1157,4,4,-5,5,1235,1162,149,167,0,0,149,167,20,100,183
520,Jul 18 2019,Indian Ocean Games in Mauritius,Mauritius,Seychelles,1082,966,1,1,-8,8,1074,974,186,191,-2,2,184,193,30,100,216
521,Jul 18 2019,Indian Ocean Games in Mauritius,Mayotte,Comoros,1219,1096,2,0,15,-15,1234,1081,145,182,6,-1,151,181,30,0,123
522,Jul 18 2019,Pacific Games in Samoa,New Caledonia,Tuvalu,1265,744,11,0,5,-5,1270,739,142,215,0,0,142,215,40,0,521
523,Jul 18 2019,Pacific Games in Samoa,Papua New Guinea,Tonga,1143,532,8,0,3,-3,1146,529,169,235,0,0,169,235,40,0,611
524,Jul 18 2019,Indian Ocean Games in Mauritius,RÃ©union,Maldives,1382,979,4,0,5,-5,1387,974,104,194,3,-1,107,193,30,0,403
525,Jul 18 2019,Pacific Games in Samoa,Samoa,Vanuatu,692,1162,0,11,-12,12,680,1174,226,166,-3,0,223,166,40,100,-370
526,Jul 18 2019,Pacific Games in Samoa,Tahiti,Eastern Samoa,1195,474,8,1,1,-1,1196,473,159,237,0,0,159,237,20,0,721
527,Jul 19 2019,African Nations Cup in Egypt,Algeria,Senegal,1674,1784,1,0,33,-33,1707,1751,34,32,7,-3,41,29,50,0,-110
528,Jul 19 2019,Friendly tournament in India,North Korea,Tajikistan,1352,1260,1,0,11,-11,1363,1249,112,150,4,-2,116,148,30,0,92
529,Jul 20 2019,Indian Ocean Games in Mauritius,Comoros,Maldives,1081,974,3,0,18,-18,1099,956,177,199,2,-3,179,196,30,0,107
530,Jul 20 2019,Pacific Games in Samoa,Fiji,Papua New Guinea,1235,1146,1,1,-5,5,1230,1151,153,169,-2,0,151,169,20,100,189
531,Jul 20 2019,Indian Ocean Games in Mauritius,Madagascar,Seychelles,1407,974,0,0,-13,13,1394,987,109,191,-3,1,106,192,30,0,433
532,Jul 20 2019,Indian Ocean Games in Mauritius,RÃ©union,Mayotte,1387,1234,1,0,9,-9,1396,1225,101,161,3,-5,104,156,30,0,153
533,Jul 22 2019,Indian Ocean Games in Mauritius,Comoros,RÃ©union,1099,1396,1,0,25,-25,1124,1371,171,120,4,-8,175,112,30,0,-297
534,Jul 22 2019,Friendly in Djibouti,Djibouti,Somalia,792,848,1,0,9,-9,801,839,208,203,0,0,208,203,20,100,44
535,Jul 22 2019,Indian Ocean Games in Mauritius,Mauritius,Madagascar,1074,1394,1,1,8,-8,1082,1386,180,108,2,-1,182,107,30,100,-220
536,Jul 22 2019,Indian Ocean Games in Mauritius,Mayotte,Maldives,1225,956,3,1,8,-8,1233,948,146,196,5,0,151,196,30,0,269
537,Jul 24 2019,Indian Ocean Games in Mauritius,Mauritius,Mayotte,1082,1233,1,0,17,-17,1099,1216,178,163,2,-6,180,157,30,100,-51
538,Jul 24 2019,Indian Ocean Games in Mauritius,RÃ©union,Seychelles,1371,987,4,0,6,-6,1377,981,108,192,2,0,110,192,30,0,384
539,Jul 26 2019,Indian Ocean Games in Mauritius,Mayotte,Seychelles,1216,981,3,1,9,-9,1225,972,155,196,1,-2,156,194,30,0,235
540,Jul 28 2019,Indian Ocean Games in Mauritius,Mauritius,RÃ©union,1099,1377,1,1,7,-7,1106,1370,180,116,0,-3,180,113,20,0,-278
541,Jul 30 2019,West Asian Championship in Iraq,Iraq,Lebanon,1594,1443,1,0,8,-8,1602,1435,55,96,2,0,57,96,40,100,251
542,Jul 30 2019,West Asian Championship in Iraq,Palestine,Yemen,1388,1154,1,0,8,-8,1396,1146,103,170,1,-1,104,169,40,0,234
543,Aug 2 2019,West Asian Championship in Iraq,Iraq,Palestine,1602,1396,2,1,6,-6,1608,1390,55,106,1,-1,56,105,40,100,306
544,Aug 2 2019,West Asian Championship in Iraq,Lebanon,Syria,1435,1486,2,1,23,-23,1458,1463,88,91,4,-3,92,88,40,0,-51
545,Aug 4 2019,West Asian Championship in Iraq,Bahrain,Jordan,1417,1491,1,0,24,-24,1441,1467,95,90,3,-3,98,87,40,0,-74
546,Aug 4 2019,West Asian Championship in Iraq,Kuwait,Saudi Arabia,1424,1566,2,1,28,-28,1452,1538,91,76,4,-4,95,72,40,0,-142
547,Aug 5 2019,West Asian Championship in Iraq,Lebanon,Palestine,1458,1390,0,0,-4,4,1454,1394,94,105,-1,0,93,105,20,100,168
548,Aug 5 2019,West Asian Championship in Iraq,Syria,Yemen,1463,1146,1,1,-14,14,1449,1160,106,167,-9,1,97,168,40,0,317
549,Aug 7 2019,West Asian Championship in Iraq,Bahrain,Saudi Arabia,1441,1538,0,0,5,-5,1446,1533,98,76,0,-2,98,74,40,0,-97
550,Aug 7 2019,West Asian Championship in Iraq,Jordan,Kuwait,1467,1452,1,1,-1,1,1466,1453,87,94,0,0,87,94,30,0,15
551,Aug 8 2019,West Asian Championship in Iraq,Iraq,Syria,1608,1449,0,0,-13,13,1595,1462,62,79,-3,9,59,88,40,100,259
552,Aug 8 2019,West Asian Championship in Iraq,Yemen,Lebanon,1160,1454,2,1,34,-34,1194,1420,154,109,7,-8,161,101,40,0,-294
553,Aug 10 2019,West Asian Championship in Iraq,Bahrain,Kuwait,1446,1453,1,0,20,-20,1466,1433,79,100,9,-3,88,97,40,0,-7
554,Aug 10 2019,West Asian Championship in Iraq,Jordan,Saudi Arabia,1466,1533,3,0,42,-42,1508,1491,65,94,11,-10,76,84,40,0,-67
555,Aug 11 2019,West Asian Championship in Iraq,Iraq,Yemen,1595,1194,2,1,2,-2,1597,1192,55,161,2,0,57,161,20,0,401
556,Aug 11 2019,West Asian Championship in Iraq,Palestine,Syria,1394,1462,4,3,24,-24,1418,1438,99,103,3,-7,102,96,40,0,-68
557,Aug 11 2019,Friendly in St Vincent & Grenadines,St Vincent & Grenadines,Trinidad and Tobago,1123,1384,1,0,14,-14,1137,1370,166,115,5,-3,171,112,20,100,-161
558,Aug 14 2019,Friendly in the Dominican Republic,Dominican Republic,Guatemala,1226,1496,0,0,5,-5,1231,1491,148,86,3,-2,151,84,20,100,-170
559,Aug 14 2019,West Asian Championship in Iraq,Iraq,Bahrain,1597,1466,0,1,-32,32,1565,1498,77,76,-10,6,67,82,40,100,231
560,Aug 18 2019,Friendly in Sint Maarten,Sint Maarten,Anguilla,828,565,2,0,3,-3,831,562,204,234,1,-1,205,233,20,100,363
561,Aug 25 2019,Friendly in Saint Kitts and Nevis,Saint Kitts and Nevis,Antigua and Barbuda,1227,1195,3,0,11,-11,1238,1184,145,172,4,-6,149,166,20,100,132
562,Aug 27 2019,Friendly in Saint Kitts and Nevis,Saint Kitts and Nevis,Antigua and Barbuda,1238,1184,4,3,6,-6,1244,1178,149,166,0,0,149,166,20,100,154
563,Aug 28 2019,Friendly in Oman,Oman,Yemen,1499,1192,1,0,2,-2,1501,1190,78,160,1,0,79,160,20,100,407
564,Aug 29 2019,Friendly in Taiwan,Taiwan,Guam,992,779,3,0,5,-5,997,774,189,212,1,-1,190,211,20,100,313
565,Aug 30 2019,Friendly in Belize,Belize,St Vincent & Grenadines,1142,1137,1,1,-3,3,1139,1140,172,169,-1,1,171,170,20,100,105
566,Aug 30 2019,Friendly in China,China,Myanmar,1485,1054,4,1,2,-2,1487,1052,88,186,-1,0,87,186,20,100,531
567,Aug 30 2019,Friendly in Malaysia,Malaysia,Jordan,1127,1508,0,1,-3,3,1124,1511,175,76,0,0,175,76,20,100,-281
568,Aug 30 2019,Friendly in Bahrain,United Arab Emirates,Dominican Republic,1483,1231,4,0,7,-7,1490,1224,85,160,1,-4,86,156,20,0,252
569,Aug 31 2019,Friendly in Bahrain,United Arab Emirates,Sri Lanka,1490,679,5,1,0,0,1490,679,86,224,0,0,86,224,20,0,811
570,Sep 1 2019,Friendly in Belize,Belize,St Vincent & Grenadines,1139,1140,1,0,7,-7,1146,1133,169,174,1,-2,170,172,20,100,99
571,Sep 4 2019,Friendly in Morocco,Burkina Faso,Libya,1534,1460,1,0,8,-8,1542,1452,72,96,0,-3,72,93,20,0,74
572,Sep 4 2019,World Cup qualifier in Burundi,Burundi,Tanzania,1303,1322,1,1,-5,5,1298,1327,136,124,0,3,136,127,40,100,81
573,Sep 4 2019,World Cup qualifier in Djibouti,Djibouti,Eswatini,801,1190,2,1,34,-34,835,1156,202,176,3,-8,205,168,40,100,-289
574,Sep 4 2019,World Cup qualifier in Sudan,Equatorial Guinea,South Sudan,1335,1020,1,1,-14,14,1321,1034,138,188,-7,0,131,188,40,0,315
575,Sep 4 2019,World Cup qualifier in Eritrea,Eritrea,Namibia,1078,1334,1,2,-12,12,1066,1346,183,119,0,3,183,122,40,100,-156
576,Sep 4 2019,World Cup qualifier in Ethiopia,Ethiopia,Lesotho,1262,1306,0,0,-3,3,1259,1309,145,134,0,0,145,134,40,100,56
577,Sep 4 2019,World Cup qualifier in Liberia,Liberia,Sierra Leone,1336,1358,3,1,23,-23,1359,1335,113,130,5,-6,118,124,40,100,78
578,Sep 4 2019,World Cup qualifier in Mauritius,Mauritius,Mozambique,1106,1274,0,1,-16,16,1090,1290,184,137,-2,2,182,139,40,100,-68
579,Sep 4 2019,World Cup qualifier in SÃ£o TomÃ© and PrÃ­ncipe,SÃ£o TomÃ© and PrÃ­ncipe,Guinea-Bissau,1076,1283,0,1,-14,14,1062,1297,184,135,0,2,184,137,40,100,-107
580,Sep 5 2019,Friendly in the United States,Argentina,Chile,1926,1810,0,0,-3,3,1923,1813,13,20,-1,0,12,20,20,0,116
581,Sep 5 2019,European Championship qual in Armenia,Armenia,Italy,1462,1922,1,3,-7,7,1455,1929,97,10,-4,1,93,11,40,100,-360
582,Sep 5 2019,World Cup & Asian Cup qual in Bahrain,Bahrain,Iraq,1498,1565,1,1,-2,2,1496,1567,84,69,-1,-1,83,68,40,100,33
583,Sep 5 2019,CONCACAF Nations League C in Barbados,Barbados,Saint Martin,1133,785,4,0,5,-5,1138,780,174,209,-1,0,173,209,40,100,448
584,Sep 5 2019,CONCACAF Nations League A in Bermuda,Bermuda,Panama,1265,1560,1,4,-17,17,1248,1577,153,57,-5,6,148,63,40,100,-195
585,Sep 5 2019,European Championship qual in Bosnia and Herzegovina,Bosnia and Herzegovina,Liechtenstein,1744,1120,5,0,1,-1,1745,1119,31,177,1,0,32,177,20,0,624
586,Sep 5 2019,World Cup & Asian Cup qual in Cambodia,Cambodia,Hong Kong,839,1186,1,1,12,-12,851,1174,205,168,-1,-3,204,165,40,100,-247
587,Sep 5 2019,World Cup qualifier in Chad,Chad,Sudan,1255,1235,1,3,-40,40,1215,1275,166,132,-10,9,156,141,40,100,120
588,Sep 5 2019,CONCACAF Nations League B in Dominica,Dominica,Suriname,1050,1287,1,2,-12,12,1038,1299,185,132,1,4,186,136,40,100,-137
589,Sep 5 2019,Friendly in the United States,Ecuador,Peru,1716,1876,1,0,14,-14,1730,1862,38,17,1,0,39,17,20,0,-160
590,Sep 5 2019,European Championship qual in the Faroe Islands,Faroe Islands,Sweden,1226,1827,0,4,-4,4,1222,1831,154,18,0,0,154,18,40,100,-501
591,Sep 5 2019,European Championship qual in Finland,Finland,Greece,1678,1575,1,0,9,-9,1687,1566,41,75,3,-6,44,69,40,100,203
592,Sep 5 2019,Friendly in Turkey,Georgia,South Korea,1527,1786,2,2,6,-6,1533,1780,74,25,0,0,74,25,20,0,-259
593,Sep 5 2019,European Championship qual in Gibraltar,Gibraltar,Denmark,1095,1890,0,6,-2,2,1093,1892,181,14,0,0,181,14,40,100,-695
594,Sep 5 2019,CONCACAF Nations League B in Grenada,Grenada,Saint Kitts and Nevis,1112,1244,2,1,22,-22,1134,1222,170,159,4,-5,174,154,40,100,-32
595,Sep 5 2019,World Cup & Asian Cup qual in Guam,Guam,Maldives,774,948,0,1,-16,16,758,964,213,192,-1,2,212,194,40,100,-74
596,Sep 5 2019,CONCACAF Nations League C in Guatemala,Guatemala,Anguilla,1491,562,10,0,0,0,1491,562,84,233,0,0,84,233,20,0,929
597,Sep 5 2019,Friendly in Honduras,Honduras,Puerto Rico,1586,976,4,0,1,-1,1587,975,56,192,2,0,58,192,20,0,610
598,Sep 5 2019,World Cup & Asian Cup qual in India,India,Oman,1206,1501,1,2,-10,10,1196,1511,156,75,1,2,157,77,40,100,-195
599,Sep 5 2019,World Cup & Asian Cup qual in Indonesia,Indonesia,Malaysia,1223,1124,2,3,-30,30,1193,1154,161,163,-2,6,159,169,40,100,199
600,Sep 5 2019,European Championship qual in Ireland,Ireland,Switzerland,1728,1901,1,1,4,-4,1732,1897,37,13,1,0,38,13,40,100,-73
601,Sep 5 2019,European Championship qual in Israel,Israel,North Macedonia,1597,1496,1,1,-10,10,1587,1506,59,73,-1,5,58,78,40,100,201
602,Sep 5 2019,Friendly in Japan,Japan,Paraguay,1745,1737,2,0,10,-10,1755,1727,26,44,3,-4,29,40,20,100,108
603,Sep 5 2019,World Cup & Asian Cup qual in Kuwait,Kuwait,Nepal,1433,887,7,0,2,-2,1435,885,99,200,-1,0,98,200,20,0,546
604,Sep 5 2019,World Cup & Asian Cup qual in Mongolia,Mongolia,Myanmar,701,1052,1,0,32,-32,733,1020,213,190,2,-2,215,188,40,100,-251
605,Sep 5 2019,Friendly in Montenegro,Montenegro,Hungary,1561,1670,2,1,10,-10,1571,1660,66,52,1,-1,67,51,20,100,-9
606,Sep 5 2019,CONCACAF Nations League B in Nicaragua,Nicaragua,St Vincent & Grenadines,1234,1133,1,1,-10,10,1224,1143,153,172,-1,0,152,172,40,100,201
607,Sep 5 2019,World Cup & Asian Cup qual in North Korea,North Korea,Lebanon,1363,1420,2,0,26,-26,1389,1394,96,107,10,-3,106,104,30,0,-57
608,Sep 5 2019,European Championship qual in Norway,Norway,Malta,1684,1190,2,0,2,-2,1686,1188,45,162,0,-1,45,161,20,0,494
609,Sep 5 2019,Friendly in Northern Ireland,Northern Ireland,Luxembourg,1678,1356,1,0,2,-2,1680,1354,49,119,-1,0,48,119,20,100,422
610,Sep 5 2019,World Cup & Asian Cup qual in Palestine,Palestine,Uzbekistan,1418,1624,2,0,39,-39,1457,1585,78,67,12,-7,90,60,40,100,-106
611,Sep 5 2019,World Cup & Asian Cup qual in the Philippines,Philippines,Syria,1132,1438,2,5,-16,16,1116,1454,182,92,-4,2,178,94,40,100,-206
612,Sep 5 2019,World Cup & Asian Cup qual in Qatar,Qatar,Afghanistan,1731,1135,6,0,2,-2,1733,1133,36,179,1,-4,37,175,30,0,596
613,Sep 5 2019,European Championship qual in Romania,Romania,Spain,1751,2028,1,2,-11,11,1740,2039,37,4,-4,0,33,4,40,100,-177
614,Sep 5 2019,Friendly in Saudi Arabia,Saudi Arabia,Mali,1491,1544,1,1,-1,1,1490,1545,86,70,-1,0,85,70,20,100,47
615,Sep 5 2019,World Cup qualifier in the Seychelles,Seychelles,Rwanda,972,1263,0,3,-17,17,955,1280,198,136,-2,4,196,140,40,100,-191
616,Sep 5 2019,World Cup & Asian Cup qual in Singapore,Singapore,Yemen,1107,1190,2,2,-1,1,1106,1191,179,160,0,0,179,160,30,100,17
617,Sep 5 2019,World Cup qualifier in Djibouti,Somalia,Zimbabwe,839,1431,1,0,39,-39,878,1392,199,112,2,-7,201,105,40,0,-592
618,Sep 5 2019,World Cup & Asian Cup qual in Sri Lanka,Sri Lanka,Turkmenistan,679,1227,0,2,-4,4,675,1231,226,145,-1,4,225,149,40,100,-448
619,Sep 5 2019,World Cup & Asian Cup qual in Taiwan,Taiwan,Jordan,997,1511,1,2,-3,3,994,1514,192,76,-1,0,191,76,30,100,-414
620,Sep 5 2019,World Cup & Asian Cup qual in Tajikistan,Tajikistan,Kyrgyzstan,1249,1292,1,0,17,-17,1266,1275,142,144,3,-3,145,141,30,0,-43
621,Sep 5 2019,World Cup & Asian Cup qual in Thailand,Thailand,Vietnam,1326,1370,0,0,-3,3,1323,1373,128,110,0,1,128,111,40,100,56
622,Sep 5 2019,CONCACAF Nations League C in the US Virgin Islands,US Virgin Islands,Cayman Islands,748,914,0,2,-24,24,724,938,218,196,-2,1,216,197,40,100,-66
623,Sep 6 2019,European Championship qual in Austria,Austria,Latvia,1736,1250,6,0,3,-3,1739,1247,30,149,3,-1,33,148,40,100,586
624,Sep 6 2019,Friendly in France,Benin,Ivory Coast,1450,1644,2,1,15,-15,1465,1629,82,52,7,0,89,52,20,0,-194
625,Sep 6 2019,CONCACAF Nations League C in CuraÃ§ao,Bonaire,British Virgin Islands,973,646,4,2,8,-8,981,638,191,226,1,0,192,226,40,0,327
626,Sep 6 2019,Friendly in the United States,Brazil,Colombia,2126,2012,2,2,-3,3,2123,2015,1,7,0,-1,1,6,20,0,114
627,Sep 6 2019,World Cup qualifier in the Comoros,Comoros,Togo,1124,1347,1,1,7,-7,1131,1340,176,123,0,-1,176,122,40,100,-123
628,Sep 6 2019,Friendly in Costa Rica,Costa Rica,Uruguay,1685,1957,1,2,-5,5,1680,1962,48,7,-1,1,47,8,20,100,-172
629,Sep 6 2019,European Championship qual in Cyprus,Cyprus,Kazakhstan,1405,1385,1,1,-7,7,1398,1392,102,101,0,4,102,105,40,100,120
630,Sep 6 2019,European Championship qual in Estonia,Estonia,Belarus,1460,1499,1,2,-23,23,1437,1522,105,68,-8,7,97,75,40,100,61
631,Sep 6 2019,World Cup qualifier in The Gambia,Gambia,Angola,1354,1363,0,1,-25,25,1329,1388,133,99,-7,9,126,108,40,100,91
632,Sep 6 2019,European Championship qual in Germany,Germany,Netherlands,1971,1980,2,4,-38,38,1933,2018,12,3,-2,2,10,5,40,100,91
633,Sep 6 2019,CONCACAF Nations League B in CuraÃ§ao,Guyana,Aruba,1186,920,1,0,7,-7,1193,913,156,198,3,0,159,198,40,0,266
634,Sep 6 2019,CONCACAF Nations League B in Jamaica,Jamaica,Antigua and Barbuda,1572,1178,6,0,5,-5,1577,1173,63,168,1,-2,64,166,40,100,494
635,Sep 6 2019,CONCACAF Nations League A in Martinique,Martinique,Trinidad and Tobago,1456,1370,1,1,-10,10,1446,1380,101,108,-5,3,96,111,40,100,186
636,Sep 6 2019,Friendly in Morocco,Morocco,Burkina Faso,1695,1542,1,1,-6,6,1689,1548,44,68,-1,2,43,70,20,100,253
637,Sep 6 2019,European Championship qual in San Marino,San Marino,Belgium,830,2049,0,4,0,0,830,2049,207,3,0,0,207,3,20,0,-1219
638,Sep 6 2019,European Championship qual in Scotland,Scotland,Russia,1666,1764,1,2,-20,20,1646,1784,52,22,-1,2,51,24,40,100,2
639,Sep 6 2019,European Championship qual in Slovakia,Slovakia,Croatia,1763,1885,0,4,-35,35,1728,1920,49,11,-11,2,38,13,40,100,-22
640,Sep 6 2019,European Championship qual in Slovenia,Slovenia,Poland,1572,1804,2,0,41,-41,1613,1763,43,31,11,-5,54,26,40,100,-132
641,Sep 6 2019,Friendly in Tunisia,Tunisia,Mauritania,1607,1346,1,0,2,-2,1609,1344,57,120,-1,1,56,121,20,100,361
642,Sep 6 2019,Friendly in the United States,United States,Mexico,1739,1885,0,3,-15,15,1724,1900,46,13,-6,1,40,14,20,100,-46
643,Sep 6 2019,European Championship qual in Wales,Wales,Azerbaijan,1746,1365,2,1,2,-2,1748,1363,29,118,1,-1,30,117,20,0,381
644,Sep 7 2019,World Cup qualifier in Botswana,Botswana,Malawi,1311,1334,0,0,-4,4,1307,1338,135,122,-1,1,134,123,40,100,77
645,Sep 7 2019,CONCACAF Nations League A in Canada,Canada,Cuba,1575,1275,6,0,8,-8,1583,1267,56,147,5,-3,61,144,40,100,400
646,Sep 7 2019,CONCACAF Nations League A in CuraÃ§ao,CuraÃ§ao,Haiti,1371,1590,1,0,27,-27,1398,1563,89,82,13,-12,102,70,40,100,-119
647,Sep 7 2019,CONCACAF Nations League B in El Salvador,El Salvador,Saint Lucia,1500,1099,3,0,4,-4,1504,1095,78,180,2,0,80,180,40,100,501
648,Sep 7 2019,European Championship qual in England,England,Bulgaria,1940,1580,4,0,5,-5,1945,1575,9,67,0,-2,9,65,40,100,460
649,Sep 7 2019,European Championship qual in France,France,Albania,2050,1504,4,1,2,-2,2052,1502,2,84,0,-2,2,82,30,0,546
650,Sep 7 2019,CONCACAF Nations League C in Guadeloupe,Guadeloupe,Sint Maarten,1186,831,5,1,5,-5,1191,826,157,208,3,-1,160,207,40,100,455
651,Sep 7 2019,European Championship qual in Iceland,Iceland,Moldova,1694,1304,3,0,4,-4,1698,1300,42,135,0,0,42,135,40,100,490
652,Sep 7 2019,European Championship qual in Kosovo,Kosovo,Czechia,1543,1738,2,1,25,-25,1568,1713,62,46,5,-6,67,40,40,100,-95
653,Sep 7 2019,Friendly in Morocco,Libya,Niger,1452,1323,2,0,10,-10,1462,1313,86,134,4,-3,90,131,20,0,129
654,Sep 7 2019,European Championship qual in Lithuania,Lithuania,Ukraine,1322,1825,0,3,-6,6,1316,1831,130,17,0,1,130,18,40,100,-403
655,Sep 7 2019,CONCACAF Nations League B in Montserrat,Montserrat,Dominican Republic,757,1224,2,1,36,-36,793,1188,205,172,4,-10,209,162,40,100,-367
656,Sep 7 2019,European Championship qual in Serbia,Serbia,Portugal,1796,1981,2,4,-23,23,1773,2004,27,7,-2,0,25,7,40,100,-85
657,Sep 7 2019,European Championship qual in Turkey,Turkey,Andorra,1760,1062,1,0,0,0,1760,1062,27,184,0,0,27,184,20,0,698
658,Sep 8 2019,European Championship qual in Armenia,Armenia,Bosnia and Herzegovina,1455,1745,4,2,45,-45,1500,1700,73,51,10,-10,83,41,40,100,-190
659,Sep 8 2019,CONCACAF Nations League B in Belize,Belize,Grenada,1146,1134,1,2,-26,26,1120,1160,181,162,-5,6,176,168,40,100,112
660,Sep 8 2019,CONCACAF Nations League C in the Cayman Islands,Cayman Islands,Barbados,938,1138,3,2,26,-26,964,1112,191,183,3,-5,194,178,40,100,-100
661,Sep 8 2019,World Cup qualifier in Equatorial Guinea,Equatorial Guinea,South Sudan,1321,1034,1,0,4,-4,1325,1030,125,185,2,1,127,186,40,100,387
662,Sep 8 2019,European Championship qual in Finland,Finland,Italy,1687,1929,1,2,-12,12,1675,1941,52,9,-4,1,48,10,40,100,-142
663,Sep 8 2019,European Championship qual in Georgia,Georgia,Denmark,1533,1892,0,0,13,-13,1546,1879,68,16,3,0,71,16,40,100,-259
664,Sep 8 2019,European Championship qual in Greece,Greece,Liechtenstein,1566,1119,1,1,-18,18,1548,1137,69,169,0,4,69,173,40,100,547
665,Sep 8 2019,Friendly in Kenya,Kenya,Uganda,1387,1471,1,1,0,0,1387,1471,110,90,0,-1,110,89,20,100,16
666,Sep 8 2019,World Cup qualifier in Lesotho,Lesotho,Ethiopia,1309,1259,1,1,-8,8,1301,1267,141,144,-4,1,137,145,40,100,150
667,Sep 8 2019,CONCACAF Nations League A in Panama,Panama,Bermuda,1577,1248,0,2,-55,55,1522,1303,85,125,-11,11,74,136,40,100,429
668,Sep 8 2019,European Championship qual in Romania,Romania,Malta,1740,1188,1,0,1,-1,1741,1187,30,164,1,-1,31,163,20,0,552
669,Sep 8 2019,World Cup qualifier in Sierra Leone,Sierra Leone,Liberia,1335,1359,1,0,16,-16,1351,1343,114,126,5,-4,119,122,30,0,-24
670,Sep 8 2019,European Championship qual in Spain,Spain,Faroe Islands,2039,1222,4,0,0,0,2039,1222,4,151,0,1,4,152,20,0,817
671,Sep 8 2019,CONCACAF Nations League B in Saint Kitts and Nevis,Saint Kitts and Nevis,French Guiana,1222,1312,2,2,-1,1,1221,1313,153,132,0,0,153,132,40,100,10
672,Sep 8 2019,CONCACAF Nations League B in St Vincent & Grenadines,St Vincent & Grenadines,Dominica,1143,1038,1,0,9,-9,1152,1029,170,188,1,-1,171,187,40,100,205
673,Sep 8 2019,CONCACAF Nations League B in Suriname,Suriname,Nicaragua,1299,1224,6,0,23,-23,1322,1201,122,158,7,-3,129,155,40,100,175
674,Sep 8 2019,European Championship qual in Sweden,Sweden,Norway,1831,1686,1,1,-12,12,1819,1698,20,39,-1,3,19,42,40,100,245
675,Sep 8 2019,European Championship qual in Switzerland,Switzerland,Gibraltar,1897,1093,4,0,0,0,1897,1093,15,181,0,0,15,181,20,0,804
676,Sep 8 2019,World Cup qualifier in Tanzania,Tanzania,Burundi,1327,1298,1,1,-7,7,1320,1305,133,133,-3,2,130,135,40,100,129
677,Sep 8 2019,CONCACAF Nations League C in Anguilla,US Virgin Islands,Saint Martin,724,780,2,1,23,-23,747,757,212,216,2,-3,214,213,40,0,-56
678,Sep 9 2019,Friendly in Algeria,Algeria,Benin,1707,1465,1,0,2,-2,1709,1463,40,90,0,0,40,90,20,100,342
679,Sep 9 2019,CONCACAF Nations League B in Antigua and Barbuda,Antigua and Barbuda,Aruba,1173,913,2,1,4,-4,1177,909,162,198,2,0,164,198,20,0,260
680,Sep 9 2019,European Championship qual in Azerbaijan,Azerbaijan,Croatia,1363,1920,1,1,17,-17,1380,1903,107,13,5,0,112,13,40,100,-457
681,Sep 9 2019,CONCACAF Nations League C in the Bahamas,Bahamas,Bonaire,854,981,2,1,22,-22,876,959,201,200,1,-4,202,196,40,100,-27
682,Sep 9 2019,European Championship qual in Estonia,Estonia,Netherlands,1437,2018,0,4,-4,4,1433,2022,99,5,-1,0,98,5,40,100,-481
683,Sep 9 2019,CONCACAF Nations League B in Guyana,Guyana,Jamaica,1193,1577,0,4,-12,12,1181,1589,168,53,-5,5,163,58,40,100,-284
684,Sep 9 2019,European Championship qual in Hungary,Hungary,Slovakia,1660,1728,1,2,-22,22,1638,1750,50,26,0,5,50,31,40,100,32
685,Sep 9 2019,Friendly in Jordan,Iraq,Uzbekistan,1567,1585,0,0,1,-1,1568,1584,65,60,1,0,66,60,20,0,-18
686,Sep 9 2019,European Championship qual in Latvia,Latvia,North Macedonia,1247,1506,0,2,-17,17,1230,1523,150,69,-1,5,149,74,40,100,-159
687,Sep 9 2019,European Championship qual in Northern Ireland,Northern Ireland,Germany,1680,1933,0,2,-18,18,1662,1951,52,7,-3,2,49,9,40,100,-153
688,Sep 9 2019,European Championship qual in Poland,Poland,Austria,1763,1739,0,0,-7,7,1756,1746,28,32,-1,0,27,32,40,100,124
689,Sep 9 2019,European Championship qual in Russia,Russia,Kazakhstan,1784,1392,1,0,2,-2,1786,1390,23,108,0,-1,23,107,20,0,392
690,Sep 9 2019,European Championship qual in San Marino,San Marino,Cyprus,830,1398,0,4,-5,5,825,1403,208,102,-1,0,207,102,40,100,-468
691,Sep 9 2019,European Championship qual in Scotland,Scotland,Belgium,1646,2049,0,4,-11,11,1635,2060,51,1,0,1,51,2,40,100,-303
692,Sep 9 2019,European Championship qual in Slovenia,Slovenia,Israel,1613,1587,3,2,13,-13,1626,1574,52,70,1,-6,53,64,40,100,126
693,Sep 9 2019,CONCACAF Nations League A in Trinidad and Tobago,Trinidad and Tobago,Martinique,1380,1446,2,2,-2,2,1378,1448,114,96,-1,0,113,96,40,100,34
694,Sep 9 2019,Friendly in Wales,Wales,Belarus,1748,1522,1,0,3,-3,1751,1519,28,80,1,-3,29,77,20,100,326
695,Sep 10 2019,World Cup & Asian Cup qual in Tajikistan,Afghanistan,Bangladesh,1133,812,1,0,5,-5,1138,807,172,208,1,0,173,208,40,0,321
696,Sep 10 2019,European Championship qual in Albania,Albania,Iceland,1502,1698,4,2,38,-38,1540,1660,62,56,10,-7,72,49,40,100,-96
697,Sep 10 2019,World Cup qualifier in Angola,Angola,Gambia,1388,1329,2,1,11,-11,1399,1318,99,134,5,-4,104,130,40,100,159
698,Sep 10 2019,Friendly in the United States,Argentina,Mexico,1923,1900,4,0,18,-18,1941,1882,10,16,1,-1,11,15,20,0,23
699,Sep 10 2019,World Cup & Asian Cup qual in Cambodia,Cambodia,Bahrain,851,1496,0,1,-2,2,849,1498,206,82,-1,1,205,83,40,100,-545
700,Sep 10 2019,CONCACAF Nations League A in the Cayman Islands,Canada,Cuba,1583,1267,1,0,6,-6,1589,1261,57,149,2,-2,59,147,40,0,316
701,Sep 10 2019,Friendly in the United States,Colombia,Venezuela,2015,1797,0,0,-6,6,2009,1803,6,19,0,1,6,20,20,0,218
702,Sep 10 2019,CONCACAF Nations League B in the Dominican Republic,Dominican Republic,El Salvador,1188,1504,1,0,31,-31,1219,1473,149,96,6,-8,155,88,40,100,-216
703,Sep 10 2019,Friendly in Ecuador,Ecuador,Bolivia,1730,1597,3,0,7,-7,1737,1590,36,59,0,-1,36,58,20,100,233
704,Sep 10 2019,European Championship qual in England,England,Kosovo,1945,1568,5,3,4,-4,1949,1564,10,66,0,0,10,66,40,100,477
705,Sep 10 2019,World Cup qualifier in Eswatini,Eswatini,Djibouti,1156,835,0,0,-17,17,1139,852,175,203,-3,1,172,204,40,100,421
706,Sep 10 2019,European Championship qual in France,France,Andorra,2052,1062,3,0,0,0,2052,1062,3,182,0,1,3,183,20,0,990
707,Sep 10 2019,World Cup & Asian Cup qual in Guam,Guam,Philippines,758,1116,1,4,-13,13,745,1129,216,175,-2,1,214,176,40,100,-258
708,Sep 10 2019,World Cup qualifier in Guinea-Bissau,Guinea-Bissau,SÃ£o TomÃ© and PrÃ­ncipe,1297,1062,2,1,5,-5,1302,1057,133,186,3,-1,136,185,40,100,335
709,Sep 10 2019,CONCACAF Nations League A in Haiti,Haiti,CuraÃ§ao,1563,1398,1,1,-13,13,1550,1411,66,99,1,2,67,101,40,100,265
710,Sep 10 2019,Friendly in Honduras,Honduras,Chile,1587,1813,2,1,13,-13,1600,1800,53,22,3,-1,56,21,20,100,-126
711,Sep 10 2019,World Cup & Asian Cup qual in Hong Kong,Hong Kong,Iran,1174,1797,0,2,-3,3,1171,1800,165,21,0,0,165,21,40,100,-523
712,Sep 10 2019,World Cup & Asian Cup qual in Indonesia,Indonesia,Thailand,1193,1323,0,3,-32,32,1161,1355,176,108,-9,10,167,118,40,100,-30
713,Sep 10 2019,Friendly in Ireland,Ireland,Bulgaria,1732,1575,3,1,6,-6,1738,1569,35,65,0,-1,35,64,20,100,257
714,Sep 10 2019,Friendly in France,Ivory Coast,Tunisia,1629,1609,2,1,9,-9,1638,1600,48,56,2,0,50,56,20,0,20
715,Sep 10 2019,Friendly in Jordan,Jordan,Paraguay,1514,1727,2,4,-10,10,1504,1737,82,35,-2,1,80,36,20,100,-113
716,Sep 10 2019,World Cup & Asian Cup qual in Kuwait,Kuwait,Australia,1435,1673,0,3,-22,22,1413,1695,103,38,-3,5,100,43,40,100,-138
717,Sep 10 2019,European Championship qual in Lithuania,Lithuania,Portugal,1316,2004,1,5,-2,2,1314,2006,131,7,0,0,131,7,30,100,-588
718,Sep 10 2019,European Championship qual in Luxembourg,Luxembourg,Serbia,1354,1773,1,3,-8,8,1346,1781,128,25,-5,0,123,25,40,100,-319
719,Sep 10 2019,World Cup qualifier in Malawi,Malawi,Botswana,1338,1307,1,0,13,-13,1351,1294,116,144,4,-5,120,139,40,100,131
720,Sep 10 2019,World Cup & Asian Cup qual in Malaysia,Malaysia,United Arab Emirates,1154,1490,1,2,-8,8,1146,1498,172,80,-1,3,171,83,40,100,-236
721,Sep 10 2019,World Cup & Asian Cup qual in the Maldives,Maldives,China,964,1487,0,5,-6,6,958,1493,197,84,-2,2,195,86,40,100,-423
722,Sep 10 2019,European Championship qual in Moldova,Moldova,Turkey,1300,1760,0,4,-8,8,1292,1768,142,26,-2,0,140,26,40,100,-360
723,Sep 10 2019,World Cup & Asian Cup qual in Mongolia,Mongolia,Tajikistan,733,1266,0,1,-3,3,730,1269,216,141,0,3,216,144,40,100,-433
724,Sep 10 2019,European Championship qual in Montenegro,Montenegro,Czechia,1571,1713,0,3,-31,31,1540,1744,79,27,-7,6,72,33,40,100,-42
725,Sep 10 2019,CONCACAF Nations League B in Montserrat,Montserrat,Saint Lucia,793,1095,1,1,10,-10,803,1085,209,182,0,-1,209,181,40,100,-202
726,Sep 10 2019,Friendly in Morocco,Morocco,Niger,1689,1313,1,0,1,-1,1690,1312,44,134,0,-1,44,133,20,100,476
727,Sep 10 2019,World Cup qualifier in Mozambique,Mozambique,Mauritius,1290,1090,2,0,9,-9,1299,1081,136,182,2,0,138,182,40,100,300
728,Sep 10 2019,World Cup & Asian Cup qual in Myanmar,Myanmar,Japan,1020,1755,0,2,-2,2,1018,1757,188,26,0,1,188,27,40,100,-635
729,Sep 10 2019,World Cup qualifier in Namibia,Namibia,Eritrea,1346,1066,2,0,6,-6,1352,1060,118,185,1,-1,119,184,40,100,380
730,Sep 10 2019,Friendly in Oman,Oman,Lebanon,1511,1394,1,0,4,-4,1515,1390,79,109,0,-2,79,107,20,100,217
731,Sep 10 2019,Friendly in the United States,Peru,Brazil,1862,2123,1,0,16,-16,1878,2107,17,1,0,0,17,1,20,0,-261
732,Sep 10 2019,CONCACAF Nations League C in Puerto Rico,Puerto Rico,Guatemala,975,1491,0,5,-7,7,968,1498,190,81,1,2,191,83,40,100,-416
733,Sep 10 2019,World Cup & Asian Cup qual in Qatar,Qatar,India,1733,1196,0,0,-19,19,1714,1215,44,156,-5,0,39,156,40,100,637
734,Sep 10 2019,World Cup qualifier in Rwanda,Rwanda,Seychelles,1280,955,7,0,7,-7,1287,948,141,195,0,1,141,196,40,100,425
735,Sep 10 2019,World Cup & Asian Cup qual in Bahrain,Saudi Arabia,Yemen,1490,1191,2,2,-14,14,1476,1205,88,155,-1,2,87,157,40,0,299
736,Sep 10 2019,World Cup & Asian Cup qual in Singapore,Singapore,Palestine,1106,1457,2,1,32,-32,1138,1425,167,102,6,-5,173,97,40,100,-251
737,Sep 10 2019,World Cup & Asian Cup qual in Sri Lanka,Sri Lanka,North Korea,675,1389,0,1,-1,1,674,1390,225,106,0,1,225,107,20,100,-614
738,Sep 10 2019,World Cup qualifier in Sudan,Sudan,Chad,1275,1215,0,0,-9,9,1266,1224,150,150,-4,2,146,152,40,100,160
739,Sep 10 2019,World Cup & Asian Cup qual in Taiwan,Taiwan,Nepal,994,885,0,2,-46,46,948,931,201,196,-5,2,196,198,40,100,209
740,Sep 10 2019,World Cup qualifier in Togo,Togo,Comoros,1340,1131,2,0,9,-9,1349,1122,121,179,1,-2,122,177,40,100,309
741,Sep 10 2019,World Cup & Asian Cup qual in Turkmenistan,Turkmenistan,South Korea,1231,1780,0,2,-4,4,1227,1784,152,24,-2,0,150,24,40,100,-449
742,Sep 10 2019,CONCACAF Nations League C in Turks and Caicos Islands,Turks and Caicos Islands,Guadeloupe,761,1191,0,3,-9,9,752,1200,213,159,-1,0,212,159,40,100,-330
743,Sep 10 2019,Friendly in Ukraine,Ukraine,Nigeria,1831,1683,2,2,-6,6,1825,1689,18,45,0,0,18,45,20,100,248
744,Sep 10 2019,Friendly in the United States,United States,Uruguay,1724,1962,1,1,4,-4,1728,1958,38,8,0,0,38,8,20,100,-138
745,Sep 10 2019,World Cup qualifier in Zimbabwe,Zimbabwe,Somalia,1392,878,3,1,2,-2,1394,876,106,201,0,0,106,201,30,0,514
746,Sep 29 2019,Friendly in Bangladesh,Bangladesh,Bhutan,807,571,4,1,4,-4,811,567,208,231,0,0,208,231,20,100,336
747,Sep 30 2019,Friendly in Botswana,Botswana,Liberia,1294,1343,0,0,-1,1,1293,1344,139,123,0,1,139,124,20,100,51
748,Oct 2 2019,Friendly in the Dominican Republic,Dominican Republic,Cuba,1219,1261,0,0,-2,2,1217,1263,155,147,0,0,155,147,20,100,58
749,Oct 2 2019,Friendly in Mexico,Mexico,Trinidad and Tobago,1882,1378,2,0,1,-1,1883,1377,15,113,0,0,15,113,20,100,604
750,Oct 3 2019,Friendly in Bangladesh,Bangladesh,Bhutan,811,567,2,0,4,-4,815,563,208,233,0,-1,208,232,20,100,344
751,Oct 4 2019,Friendly in Saint Lucia,Saint Lucia,Dominica,1085,1029,3,1,9,-9,1094,1020,179,187,1,0,180,187,20,100,156
752,Oct 5 2019,Friendly in Jordan,Jordan,Singapore,1504,1138,0,0,-9,9,1495,1147,90,171,-5,1,85,172,20,100,466
753,Oct 5 2019,Friendly in Malaysia,Malaysia,Sri Lanka,1146,674,6,0,2,-2,1148,672,171,225,0,0,171,225,20,100,572
754,Oct 6 2019,Friendly in Saint Lucia,Saint Lucia,Dominica,1094,1020,1,4,-26,26,1068,1046,184,185,-2,1,182,186,20,100,174
755,Oct 9 2019,Friendly in Bahrain,Bahrain,Azerbaijan,1498,1380,2,3,-16,16,1482,1396,90,98,-4,7,86,105,20,100,218
756,Oct 9 2019,African Nations Cup qualifier in Djibouti,Djibouti,Gambia,852,1318,1,1,16,-16,868,1302,204,140,0,-5,204,135,40,100,-366
757,Oct 9 2019,Friendly in Germany,Germany,Argentina,1951,1941,2,2,-3,3,1948,1944,11,11,-1,0,10,11,20,100,110
758,Oct 9 2019,African Nations Cup qualifier in Liberia,Liberia,Chad,1344,1224,1,0,9,-9,1353,1215,114,158,5,-3,119,155,40,100,220
759,Oct 9 2019,African Nations Cup qualifier in Mauritius,Mauritius,SÃ£o TomÃ© and PrÃ­ncipe,1081,1057,1,3,-40,40,1041,1097,193,175,-6,5,187,180,40,100,124
760,Oct 9 2019,African Nations Cup qualifier in Sudan,South Sudan,Seychelles,1030,948,2,1,15,-15,1045,933,185,198,1,-1,186,197,40,0,82
761,Oct 10 2019,Friendly in Algeria,Algeria,DR Congo,1709,1521,1,1,-7,7,1702,1528,40,75,0,1,40,76,20,100,288
762,Oct 10 2019,World Cup & Asian Cup qual in Australia,Australia,Nepal,1695,931,5,0,1,-1,1696,930,43,198,0,0,43,198,30,0,764
763,Oct 10 2019,European Championship qual in Austria,Austria,Israel,1746,1574,3,1,10,-10,1756,1564,30,69,1,-3,31,66,40,100,272
764,Oct 10 2019,CONCACAF Nations League C in Saint Kitts and Nevis,Bahamas,British Virgin Islands,876,638,4,0,15,-15,891,623,201,230,0,-2,201,228,40,0,238
765,Oct 10 2019,World Cup & Asian Cup qual in Bangladesh,Bangladesh,Qatar,815,1714,0,2,-1,1,814,1715,206,39,1,0,207,39,40,100,-799
766,Oct 10 2019,European Championship qual in Belarus,Belarus,Estonia,1519,1433,0,0,-10,10,1509,1443,80,96,-1,0,79,96,40,100,186
767,Oct 10 2019,European Championship qual in Belgium,Belgium,San Marino,2060,825,9,0,0,0,2060,825,2,205,0,1,2,206,20,0,1235
768,Oct 10 2019,CONCACAF Nations League B in Belize,Belize,Saint Kitts and Nevis,1120,1221,0,4,-37,37,1083,1258,184,143,-3,5,181,148,40,100,-1
769,Oct 10 2019,Friendly in Singapore,Brazil,Senegal,2107,1751,1,1,-8,8,2099,1759,1,27,0,1,1,28,20,0,356
770,Oct 10 2019,Friendly in France,Cape Verde,Togo,1395,1349,2,1,9,-9,1404,1340,102,127,2,-2,104,125,20,0,46
771,Oct 10 2019,World Cup & Asian Cup qual in China,China,Guam,1493,745,7,0,1,-1,1494,744,83,214,1,0,84,214,20,0,748
772,Oct 10 2019,CONCACAF Nations League A in the Bahamas,Costa Rica,Haiti,1680,1550,1,1,-7,7,1673,1557,48,67,-1,0,47,67,40,0,130
773,Oct 10 2019,European Championship qual in Croatia,Croatia,Hungary,1903,1638,3,0,8,-8,1911,1630,13,52,0,-1,13,51,40,100,365
774,Oct 10 2019,CONCACAF Nations League B in French Guiana,French Guiana,Grenada,1313,1160,0,0,-12,12,1301,1172,141,162,-5,3,136,165,40,100,253
775,Oct 10 2019,Friendly in France,Gabon,Burkina Faso,1409,1548,1,0,14,-14,1423,1534,100,80,1,-6,101,74,20,0,-139
776,Oct 10 2019,World Cup & Asian Cup qual in Iran,Iran,Cambodia,1800,849,14,0,0,0,1800,849,21,205,0,0,21,205,20,0,951
777,Oct 10 2019,World Cup & Asian Cup qual in Iraq,Iraq,Hong Kong,1568,1171,2,0,3,-3,1571,1168,61,167,2,-1,63,166,20,0,397
778,Oct 10 2019,World Cup & Asian Cup qual in Japan,Japan,Mongolia,1757,730,6,0,0,0,1757,730,31,216,-2,0,29,216,20,0,1027
779,Oct 10 2019,World Cup & Asian Cup qual in Jordan,Jordan,Kuwait,1495,1413,0,0,-10,10,1485,1423,86,102,-1,-1,85,101,40,100,182
780,Oct 10 2019,European Championship qual in Kazakhstan,Kazakhstan,Cyprus,1390,1403,1,2,-25,25,1365,1428,124,91,-8,6,116,97,40,100,87
781,Oct 10 2019,Friendly in Kosovo,Kosovo,Gibraltar,1564,1093,1,0,1,-1,1565,1092,64,179,1,1,65,180,20,0,471
782,Oct 10 2019,World Cup & Asian Cup qual in Kyrgyzstan,Kyrgyzstan,Myanmar,1275,1018,7,0,10,-10,1285,1008,142,188,0,0,142,188,40,100,357
783,Oct 10 2019,European Championship qual in Latvia,Latvia,Poland,1230,1756,0,3,-6,6,1224,1762,154,26,-3,1,151,27,40,100,-426
784,Oct 10 2019,World Cup & Asian Cup qual in Lebanon,Lebanon,Turkmenistan,1390,1227,2,1,7,-7,1397,1220,104,156,2,-3,106,153,40,100,263
785,Oct 10 2019,European Championship qual in the Netherlands,Netherlands,Northern Ireland,2022,1662,3,1,4,-4,2026,1658,5,50,0,-1,5,49,40,100,460
786,Oct 10 2019,Friendly in Niger,Niger,Zambia,1312,1450,1,1,1,-1,1313,1449,130,94,1,0,131,94,20,100,-38
787,Oct 10 2019,European Championship qual in North Macedonia,North Macedonia,Slovenia,1523,1626,2,1,20,-20,1543,1606,67,59,4,-3,71,56,40,100,-3
788,Oct 10 2019,World Cup & Asian Cup qual in Oman,Oman,Afghanistan,1515,1138,3,0,4,-4,1519,1134,77,176,1,-1,78,175,20,0,377
789,Oct 10 2019,European Championship qual in Russia,Russia,Scotland,1786,1635,4,0,14,-14,1800,1621,19,52,2,0,21,52,40,100,251
790,Oct 10 2019,World Cup & Asian Cup qual in Saudi Arabia,Saudi Arabia,Singapore,1476,1147,3,0,5,-5,1481,1142,87,172,0,0,87,172,20,0,329
791,Oct 10 2019,Friendly in Serbia,Serbia,Paraguay,1781,1737,1,0,6,-6,1787,1731,23,38,1,-1,24,37,20,100,144
792,Oct 10 2019,European Championship qual in Slovakia,Slovakia,Wales,1750,1751,1,1,-6,6,1744,1757,33,29,-1,0,32,29,40,100,99
793,Oct 10 2019,World Cup & Asian Cup qual in South Korea,South Korea,Sri Lanka,1784,672,8,0,0,0,1784,672,26,225,-1,0,25,225,20,0,1112
794,Oct 10 2019,World Cup & Asian Cup qual in the United Arab Emirates,Syria,Maldives,1454,958,2,1,2,-2,1456,956,91,195,1,0,92,195,30,0,496
795,Oct 10 2019,Friendly in Thailand,Thailand,Congo,1355,1375,1,1,-2,2,1353,1377,118,112,0,1,118,113,20,100,80
796,Oct 10 2019,CONCACAF Nations League A in Trinidad and Tobago,Trinidad and Tobago,Honduras,1377,1600,0,2,-20,20,1357,1620,121,50,-4,3,117,53,40,100,-123
797,Oct 10 2019,CONCACAF Nations League C in CuraÃ§ao,Turks and Caicos Islands,Sint Maarten,752,826,5,2,42,-42,794,784,206,214,3,-4,209,210,40,0,-74
798,Oct 10 2019,World Cup & Asian Cup qual in the United Arab Emirates,United Arab Emirates,Indonesia,1498,1161,5,0,6,-6,1504,1155,78,169,2,-1,80,168,40,100,437
799,Oct 10 2019,World Cup & Asian Cup qual in Uzbekistan,Uzbekistan,Yemen,1584,1205,5,0,5,-5,1589,1200,55,159,3,-1,58,158,40,100,479
800,Oct 10 2019,Friendly in Venezuela,Venezuela,Bolivia,1803,1590,4,1,5,-5,1808,1585,20,64,0,-3,20,61,20,100,313
801,Oct 10 2019,World Cup & Asian Cup qual in Vietnam,Vietnam,Malaysia,1373,1148,1,0,5,-5,1378,1143,109,171,3,0,112,171,40,100,325
802,Oct 11 2019,European Championship qual in Andorra,Andorra,Moldova,1062,1292,1,0,27,-27,1089,1265,179,152,2,-6,181,146,40,100,-130
803,Oct 11 2019,CONCACAF Nations League B in Antigua and Barbuda,Antigua and Barbuda,Guyana,1177,1181,2,1,15,-15,1192,1166,159,170,2,-4,161,166,30,0,-4
804,Oct 11 2019,CONCACAF Nations League A in Bermuda,Bermuda,Mexico,1303,1883,1,5,-4,4,1299,1887,141,15,-4,0,137,15,40,100,-480
805,Oct 11 2019,European Championship qual in Czechia,Czechia,England,1744,1949,2,1,26,-26,1770,1923,22,15,5,-3,27,12,40,100,-105
806,Oct 11 2019,European Championship qual in Iceland,Iceland,France,1660,2052,0,1,-6,6,1654,2058,50,3,-1,0,49,3,40,100,-292
807,Oct 11 2019,European Championship qual in Montenegro,Montenegro,Bulgaria,1540,1569,0,0,-4,4,1536,1573,72,62,0,1,72,63,40,100,71
808,Oct 11 2019,Friendly in Morocco,Morocco,Libya,1690,1462,1,1,-7,7,1683,1469,46,89,-1,1,45,90,20,100,328
809,Oct 11 2019,CONCACAF Nations League B in Nicaragua,Nicaragua,Dominica,1201,1046,3,1,11,-11,1212,1035,157,189,0,-2,157,187,40,100,255
810,Oct 11 2019,European Championship qual in Portugal,Portugal,Luxembourg,2006,1346,3,0,1,-1,2007,1345,7,123,0,0,7,123,20,0,660
811,Oct 11 2019,CONCACAF Nations League B in St Vincent & Grenadines,St Vincent & Grenadines,Suriname,1152,1322,2,2,4,-4,1156,1318,167,130,1,-1,168,129,40,100,-70
812,Oct 11 2019,European Championship qual in Turkey,Turkey,Albania,1768,1540,1,0,5,-5,1773,1535,26,74,0,-1,26,73,40,100,328
813,Oct 11 2019,European Championship qual in Ukraine,Ukraine,Lithuania,1825,1314,2,0,2,-2,1827,1312,18,132,0,-1,18,131,20,0,511
814,Oct 11 2019,Friendly in Uruguay,Uruguay,Peru,1958,1878,1,0,5,-5,1963,1873,8,17,0,0,8,17,20,100,180
815,Oct 11 2019,CONCACAF Nations League A in the United States,United States,Cuba,1728,1263,7,0,3,-3,1731,1260,36,147,1,0,37,147,20,0,465
816,Oct 12 2019,CONCACAF Nations League C in Anguilla,Anguilla,Guatemala,562,1498,0,5,-1,1,561,1499,233,81,0,1,233,82,40,100,-836
817,Oct 12 2019,CONCACAF Nations League C in Barbados,Barbados,US Virgin Islands,1112,747,1,0,3,-3,1115,744,178,213,0,0,178,213,30,0,365
818,Oct 12 2019,European Championship qual in Bosnia and Herzegovina,Bosnia and Herzegovina,Finland,1700,1675,4,1,23,-23,1723,1652,37,52,2,-3,39,49,40,100,125
819,Oct 12 2019,Friendly in Spain,Chile,Colombia,1800,2009,0,0,5,-5,1805,2004,21,8,0,-1,21,7,20,0,-209
820,Oct 12 2019,Friendly in France,Comoros,Guinea,1122,1425,1,0,17,-17,1139,1408,171,108,3,-5,174,103,20,0,-303
821,Oct 12 2019,European Championship qual in Denmark,Denmark,Switzerland,1879,1897,1,0,15,-15,1894,1882,12,18,2,-2,14,16,40,100,82
822,Oct 12 2019,CONCACAF Nations League B in the Dominican Republic,Dominican Republic,Saint Lucia,1217,1068,3,0,13,-13,1230,1055,144,185,5,-1,149,184,40,100,249
823,Oct 12 2019,European Championship qual in the Faroe Islands,Faroe Islands,Romania,1222,1741,0,3,-6,6,1216,1747,156,32,-2,1,154,33,40,100,-419
824,Oct 12 2019,European Championship qual in Georgia,Georgia,Ireland,1546,1738,0,0,5,-5,1551,1733,67,37,1,-1,68,36,20,0,-192
825,Oct 12 2019,European Championship qual in Italy,Italy,Greece,1941,1548,2,0,3,-3,1944,1545,9,70,1,-1,10,69,20,0,393
826,Oct 12 2019,CONCACAF Nations League B in Jamaica,Jamaica,Aruba,1589,909,2,0,1,-1,1590,908,58,199,0,0,58,199,20,0,680
827,Oct 12 2019,European Championship qual in Liechtenstein,Liechtenstein,Armenia,1137,1500,1,1,13,-13,1150,1487,168,86,3,-2,171,84,40,100,-263
828,Oct 12 2019,European Championship qual in Malta,Malta,Sweden,1187,1819,0,4,-3,3,1184,1822,162,19,0,0,162,19,30,100,-532
829,Oct 12 2019,CONCACAF Nations League B in Montserrat,Montserrat,El Salvador,803,1473,0,2,-2,2,801,1475,210,88,-1,0,209,88,30,100,-570
830,Oct 12 2019,European Championship qual in Norway,Norway,Spain,1698,2039,1,1,12,-12,1710,2027,40,4,1,0,41,4,40,100,-241
831,Oct 12 2019,CONCACAF Nations League C in Anguilla,Saint Martin,Cayman Islands,757,964,3,0,54,-54,811,910,204,204,4,-6,208,198,40,0,-207
832,Oct 12 2019,Friendly in Tunisia,Tunisia,Cameroon,1600,1581,0,0,-3,3,1597,1584,57,62,0,0,57,62,20,100,119
833,Oct 13 2019,Friendly in Spain,Argentina,Ecuador,1944,1737,6,1,9,-9,1953,1728,10,41,0,-3,10,38,20,0,207
834,Oct 13 2019,European Championship qual in Belarus,Belarus,Netherlands,1509,2026,1,2,-3,3,1506,2029,79,3,0,1,79,4,40,100,-417
835,Oct 13 2019,Friendly in Benin,Benin,Zambia,1463,1449,2,2,-3,3,1460,1452,91,94,0,0,91,94,20,100,114
836,Oct 13 2019,CONCACAF Nations League C in Saint Kitts and Nevis,Bonaire,British Virgin Islands,959,623,4,3,5,-5,964,618,191,230,1,-1,192,229,40,0,336
837,Oct 13 2019,Friendly in Singapore,Brazil,Nigeria,2099,1689,1,1,-8,8,2091,1697,1,42,0,1,1,43,20,0,410
838,Oct 13 2019,African Nations Cup qualifier in Chad,Chad,Liberia,1215,1353,1,0,22,-22,1237,1331,141,134,7,-8,148,126,40,100,-38
839,Oct 13 2019,CONCACAF Nations League A in Costa Rica,Costa Rica,CuraÃ§ao,1673,1411,0,0,-16,16,1657,1427,48,92,-1,5,47,97,40,100,362
840,Oct 13 2019,European Championship qual in Cyprus,Cyprus,Russia,1428,1800,0,5,-14,14,1414,1814,107,18,-5,2,102,20,40,100,-272
841,Oct 13 2019,Friendly in France,Equatorial Guinea,Togo,1325,1340,1,1,0,0,1325,1340,127,125,0,0,127,125,20,0,-15
842,Oct 13 2019,European Championship qual in Estonia,Estonia,Germany,1443,1948,0,3,-6,6,1437,1954,96,9,0,0,96,9,40,100,-405
843,Oct 13 2019,Friendly in Ethiopia,Ethiopia,Uganda,1267,1471,0,1,-7,7,1260,1478,148,87,-2,1,146,88,20,100,-104
844,Oct 13 2019,African Nations Cup qualifier in The Gambia,Gambia,Djibouti,1302,868,1,1,-18,18,1284,886,147,200,-7,2,140,202,40,100,534
845,Oct 13 2019,CONCACAF Nations League B in Grenada,Grenada,French Guiana,1172,1301,1,0,22,-22,1194,1279,158,147,3,-6,161,141,40,100,-29
846,Oct 13 2019,CONCACAF Nations League A in Honduras,Honduras,Martinique,1620,1448,1,0,7,-7,1627,1441,51,95,1,0,52,95,40,100,272
847,Oct 13 2019,European Championship qual in Hungary,Hungary,Azerbaijan,1630,1396,1,0,5,-5,1635,1391,51,109,0,-1,51,108,40,100,334
848,Oct 13 2019,Friendly in France,Ivory Coast,DR Congo,1638,1528,3,1,10,-10,1648,1518,50,80,0,-2,50,78,20,0,110
849,Oct 13 2019,European Championship qual in Kazakhstan,Kazakhstan,Belgium,1365,2060,0,2,-2,2,1363,2062,116,2,0,0,116,2,40,100,-595
850,Oct 13 2019,Friendly in Kenya,Kenya,Mozambique,1387,1299,0,1,-15,15,1372,1314,116,123,-3,7,113,130,20,100,188
851,Oct 13 2019,Friendly in Lesotho,Lesotho,Malawi,1301,1351,1,1,-1,1,1300,1352,133,117,1,2,134,119,20,100,50
852,Oct 13 2019,Friendly in Niger,Niger,Central African Republic,1313,1334,0,2,-18,18,1295,1352,142,112,-6,7,136,119,20,100,79
853,Oct 13 2019,European Championship qual in Poland,Poland,North Macedonia,1762,1543,2,0,8,-8,1770,1535,28,73,0,-1,28,72,40,100,319
854,Oct 13 2019,African Nations Cup qualifier in SÃ£o TomÃ© and PrÃ­ncipe,SÃ£o TomÃ© and PrÃ­ncipe,Mauritius,1097,1041,2,1,12,-12,1109,1029,181,188,-1,-1,180,187,40,100,156
855,Oct 13 2019,European Championship qual in Scotland,Scotland,San Marino,1621,825,6,0,0,0,1621,825,54,206,-1,0,53,206,20,0,796
856,Oct 13 2019,African Nations Cup qualifier in the Seychelles,Seychelles,South Sudan,933,1045,0,1,-19,19,914,1064,198,181,-1,2,197,183,40,100,-12
857,Oct 13 2019,Friendly in Slovakia,Slovakia,Paraguay,1744,1731,1,1,-3,3,1741,1734,34,33,0,2,34,35,20,100,113
858,Oct 13 2019,European Championship qual in Slovenia,Slovenia,Austria,1606,1756,0,1,-17,17,1589,1773,60,20,-2,6,58,26,40,100,-50
859,Oct 13 2019,Friendly tournament in South Africa,South Africa,Mali,1534,1545,2,1,11,-11,1545,1534,64,79,5,-5,69,74,30,100,89
860,Oct 13 2019,CONCACAF Nations League B in Saint Kitts and Nevis,Saint Kitts and Nevis,Belize,1258,1083,0,1,-33,33,1225,1116,154,174,-3,4,151,178,40,100,275
861,Oct 13 2019,European Championship qual in Wales,Wales,Croatia,1757,1911,1,1,3,-3,1760,1908,30,13,0,0,30,13,40,100,-54
862,Oct 14 2019,European Championship qual in Bulgaria,Bulgaria,England,1573,1923,0,6,-16,16,1557,1939,69,12,-3,0,66,12,40,100,-250
863,Oct 14 2019,Friendly in Czechia,Czechia,Northern Ireland,1770,1658,2,3,-15,15,1755,1673,36,46,-4,0,32,46,20,100,212
864,Oct 14 2019,CONCACAF Nations League B in Dominica,Dominica,Nicaragua,1035,1212,0,4,-29,29,1006,1241,190,139,-2,9,188,148,40,100,-77
865,Oct 14 2019,Friendly in Egypt,Egypt,Botswana,1611,1293,1,0,2,-2,1613,1291,55,135,0,1,55,136,20,100,418
866,Oct 14 2019,European Championship qual in France,France,Turkey,2058,1773,1,1,-16,16,2042,1789,3,24,0,1,3,25,40,100,385
867,Oct 14 2019,CONCACAF Nations League C in CuraÃ§ao,Guadeloupe,Sint Maarten,1200,784,2,1,3,-3,1203,781,158,211,0,0,158,211,30,0,416
868,Oct 14 2019,CONCACAF Nations League B in Guyana,Guyana,Antigua and Barbuda,1166,1192,5,1,30,-30,1196,1162,154,172,6,-5,160,167,30,0,-26
869,Oct 14 2019,European Championship qual in Iceland,Iceland,Andorra,1654,1089,2,0,1,-1,1655,1088,48,182,0,0,48,182,20,0,565
870,Oct 14 2019,European Championship qual in Kosovo,Kosovo,Montenegro,1565,1536,2,0,19,-19,1584,1517,59,85,3,-7,62,78,40,100,129
871,Oct 14 2019,European Championship qual in Lithuania,Lithuania,Serbia,1312,1787,1,2,-4,4,1308,1791,129,24,1,0,130,24,40,100,-375
872,Oct 14 2019,European Championship qual in Moldova,Moldova,Albania,1265,1535,0,4,-20,20,1245,1555,149,64,-2,4,147,68,40,100,-170
873,Oct 14 2019,Friendly in Rwanda,Rwanda,Tanzania,1287,1320,0,0,-2,2,1285,1322,136,128,1,0,137,128,20,100,67
874,Oct 14 2019,CONCACAF Nations League B in Suriname,Suriname,St Vincent & Grenadines,1318,1156,0,1,-33,33,1285,1189,145,158,-8,5,137,163,40,100,262
875,Oct 14 2019,European Championship qual in Ukraine,Ukraine,Portugal,1827,2007,2,1,25,-25,1852,1982,18,8,0,-1,18,7,40,100,-80
876,Oct 14 2019,Friendly in Venezuela,Venezuela,Trinidad and Tobago,1808,1357,2,0,1,-1,1809,1356,21,117,0,0,21,117,20,100,551
877,Oct 15 2019,Friendly in France,Algeria,Colombia,1702,2004,3,0,30,-30,1732,1974,30,8,6,-1,36,7,20,0,-302
878,Oct 15 2019,CONCACAF Nations League C in Anguilla,Anguilla,Puerto Rico,561,968,2,3,-6,6,555,974,233,191,0,0,233,191,40,100,-307
879,Oct 15 2019,World Cup & Asian Cup qual in Bahrain,Bahrain,Iran,1482,1800,1,0,31,-31,1513,1769,70,33,8,-5,78,28,40,100,-218
880,Oct 15 2019,Friendly in Bermuda,Bermuda,Guatemala,1299,1499,0,0,3,-3,1302,1496,130,82,2,0,132,82,20,100,-100
881,Oct 15 2019,Friendly in Bolivia,Bolivia,Haiti,1585,1557,3,1,10,-10,1595,1547,57,74,2,-4,59,70,20,100,128
882,Oct 15 2019,World Cup & Asian Cup qual in Cambodia,Cambodia,Iraq,849,1571,0,4,-2,2,847,1573,205,64,0,0,205,64,30,100,-622
883,Oct 15 2019,CONCACAF Nations League A in Canada,Canada,United States,1589,1731,2,0,34,-34,1623,1697,48,49,5,-6,53,43,40,100,-42
884,Oct 15 2019,CONCACAF Nations League C in the Cayman Islands,Cayman Islands,Saint Martin,910,811,1,0,10,-10,920,801,196,210,1,-1,197,209,40,100,199
885,Oct 15 2019,Friendly in Spain,Chile,Guinea,1805,1408,3,2,2,-2,1807,1406,22,103,0,0,22,103,20,0,397
886,Oct 15 2019,Friendly in Denmark,Denmark,Luxembourg,1894,1345,4,0,1,-1,1895,1344,14,125,0,-1,14,124,20,100,649
887,Oct 15 2019,CONCACAF Nations League B in the Dominican Republic,Dominican Republic,Montserrat,1230,801,0,0,-18,18,1212,819,162,207,-6,1,156,208,40,100,529
888,Oct 15 2019,European Championship qual in the Faroe Islands,Faroe Islands,Malta,1216,1184,1,0,13,-13,1229,1171,146,166,5,-1,151,165,40,100,132
889,Oct 15 2019,European Championship qual in Finland,Finland,Armenia,1652,1487,3,0,13,-13,1665,1474,43,94,3,-5,46,89,40,100,265
890,Oct 15 2019,European Championship qual in Gibraltar,Gibraltar,Georgia,1092,1551,2,3,-4,4,1088,1555,181,67,0,1,181,68,40,100,-359
891,Oct 15 2019,European Championship qual in Greece,Greece,Bosnia and Herzegovina,1545,1723,2,1,24,-24,1569,1699,60,43,5,-2,65,41,40,100,-78
892,Oct 15 2019,World Cup & Asian Cup qual in India,India,Bangladesh,1215,814,1,1,-18,18,1197,832,161,205,-2,1,159,206,40,100,501
893,Oct 15 2019,World Cup & Asian Cup qual in Indonesia,Indonesia,Vietnam,1155,1378,1,3,-20,20,1135,1398,181,105,-6,3,175,108,40,100,-123
894,Oct 15 2019,European Championship qual in Israel,Israel,Latvia,1564,1224,3,1,4,-4,1568,1220,67,156,-1,-1,66,155,20,0,340
895,Oct 15 2019,CONCACAF Nations League B in CuraÃ§ao,Jamaica,Aruba,1590,908,6,0,2,-2,1592,906,63,199,-3,0,60,199,40,0,682
896,Oct 15 2019,World Cup & Asian Cup qual in Jordan,Jordan,Nepal,1485,930,3,0,2,-2,1487,928,81,196,2,0,83,196,30,0,555
897,Oct 15 2019,Friendly in Kuwait,Kuwait,Turkmenistan,1423,1220,1,1,-7,7,1416,1227,102,149,-1,3,101,152,20,100,303
898,Oct 15 2019,European Championship qual in Liechtenstein,Liechtenstein,Italy,1150,1944,0,5,-1,1,1149,1945,169,11,1,0,170,11,20,100,-694
899,Oct 15 2019,Friendly in Mauritania,Mauritania,Libya,1344,1469,0,0,1,-1,1345,1468,122,90,1,0,123,90,20,100,-25
900,Oct 15 2019,CONCACAF Nations League A in Mexico,Mexico,Panama,1887,1522,3,1,4,-4,1891,1518,17,75,-1,0,16,75,40,100,465
901,Oct 15 2019,World Cup & Asian Cup qual in Mongolia,Mongolia,Kyrgyzstan,730,1285,1,2,-3,3,727,1288,216,137,0,0,216,137,40,100,-455
902,Oct 15 2019,Friendly in Morocco,Morocco,Gabon,1683,1423,2,3,-18,18,1665,1441,47,90,-1,5,46,95,20,100,360
903,Oct 15 2019,World Cup & Asian Cup qual in North Korea,North Korea,South Korea,1390,1784,0,0,14,-14,1404,1770,99,26,5,0,104,26,40,100,-294
904,Oct 15 2019,World Cup & Asian Cup qual in Palestine,Palestine,Saudi Arabia,1425,1481,0,0,-3,3,1422,1484,102,81,-2,3,100,84,40,100,44
905,Oct 15 2019,Friendly in Peru,Peru,Uruguay,1873,1963,1,1,0,0,1873,1963,17,8,0,0,17,8,20,100,10
906,Oct 15 2019,World Cup & Asian Cup qual in the Philippines,Philippines,China,1129,1494,0,0,13,-13,1142,1481,167,89,5,-3,172,86,40,100,-265
907,Oct 15 2019,World Cup & Asian Cup qual in Qatar,Qatar,Oman,1715,1519,2,1,6,-6,1721,1513,36,80,2,-2,38,78,40,100,296
908,Oct 15 2019,European Championship qual in Romania,Romania,Norway,1747,1710,1,1,-8,8,1739,1718,35,39,-1,1,34,40,40,100,137
909,Oct 15 2019,World Cup & Asian Cup qual in Singapore,Singapore,Uzbekistan,1142,1589,1,3,-7,7,1135,1596,177,58,-2,0,175,58,40,100,-347
910,Oct 15 2019,World Cup & Asian Cup qual in Sri Lanka,Sri Lanka,Lebanon,672,1397,0,3,-2,2,670,1399,225,106,0,0,225,106,40,100,-625
911,Oct 15 2019,CONCACAF Nations League B in Saint Lucia,Saint Lucia,El Salvador,1055,1475,0,2,-8,8,1047,1483,185,81,0,4,185,85,40,100,-320
912,Oct 15 2019,European Championship qual in Sweden,Sweden,Spain,1822,2027,1,1,6,-6,1828,2021,19,5,0,0,19,5,40,100,-105
913,Oct 15 2019,European Championship qual in Switzerland,Switzerland,Ireland,1882,1733,2,0,12,-12,1894,1721,14,40,1,-2,15,38,40,100,249
914,Oct 15 2019,World Cup & Asian Cup qual in the United Arab Emirates,Syria,Guam,1456,744,4,0,1,-1,1457,743,92,213,0,0,92,213,20,0,712
915,Oct 15 2019,World Cup & Asian Cup qual in Taiwan,Taiwan,Australia,948,1696,1,7,-2,2,946,1698,195,40,0,2,195,42,40,100,-648
916,Oct 15 2019,World Cup & Asian Cup qual in Tajikistan,Tajikistan,Japan,1269,1757,0,3,-7,7,1262,1764,145,27,-1,2,144,29,40,100,-388
917,Oct 15 2019,World Cup & Asian Cup qual in Thailand,Thailand,United Arab Emirates,1353,1504,2,1,23,-23,1376,1481,108,92,5,-6,113,86,40,100,-51
918,Oct 15 2019,CONCACAF Nations League C in the US Virgin Islands,US Virgin Islands,Barbados,744,1115,0,4,-13,13,731,1128,217,177,-2,1,215,178,40,100,-271
919,Nov 5 2019,Friendly in Malaysia,Malaysia,Maldives,1143,956,2,1,3,-3,1146,953,171,194,0,0,171,194,20,100,287
920,Nov 7 2019,Friendly in Egypt,Egypt,Liberia,1613,1331,1,0,2,-2,1615,1329,54,126,1,0,55,126,20,100,382
921,Nov 7 2019,Friendly in Myanmar,Myanmar,Nepal,1008,928,3,0,9,-9,1017,919,187,198,0,-1,187,197,20,100,180
922,Nov 7 2019,Friendly in Nicaragua,Nicaragua,Cuba,1241,1260,0,0,-2,2,1239,1262,148,143,0,1,148,144,20,100,81
923,Nov 9 2019,Friendly in Malaysia,Malaysia,Tajikistan,1146,1262,1,0,10,-10,1156,1252,167,148,2,-2,169,146,20,100,-16
924,Nov 9 2019,Friendly in Namibia,Namibia,Zambia,1352,1452,0,2,-15,15,1337,1467,131,88,-6,3,125,91,20,100,0
925,Nov 9 2019,Friendly in Uzbekistan,Uzbekistan,Kyrgyzstan,1596,1288,3,1,3,-3,1599,1285,56,137,1,0,57,137,20,100,408
926,Nov 10 2019,Friendly in Nicaragua,Nicaragua,Cuba,1239,1262,0,1,-12,12,1227,1274,154,140,-3,2,151,142,20,100,77
927,Nov 10 2019,Friendly in Trinidad and Tobago,Trinidad and Tobago,Anguilla,1356,555,15,0,0,0,1356,555,118,233,0,0,118,233,20,100,901
928,Nov 13 2019,African Nations Cup qualifier in Angola,Angola,Gambia,1399,1284,1,3,-47,47,1352,1331,134,112,-14,14,120,126,40,100,215
929,Nov 13 2019,African Nations Cup qualifier in Burkina Faso,Burkina Faso,Uganda,1534,1478,0,0,-8,8,1526,1486,75,80,-1,4,74,84,40,100,156
930,Nov 13 2019,African Nations Cup qualifier in Cameroon,Cameroon,Cape Verde,1584,1404,0,0,-13,13,1571,1417,66,98,-2,3,64,101,40,100,280
931,Nov 13 2019,African Nations Cup qualifier in Central African Republic,Central African Republic,Burundi,1352,1305,2,0,18,-18,1370,1287,111,143,4,-6,115,137,40,100,147
932,Nov 13 2019,African Nations Cup qualifier in Guinea-Bissau,Guinea-Bissau,Eswatini,1302,1139,3,0,13,-13,1315,1126,128,183,2,-5,130,178,40,100,263
933,Nov 13 2019,African Nations Cup qualifier in Malawi,Malawi,South Sudan,1352,1064,1,0,4,-4,1356,1060,117,183,1,0,118,183,40,100,388
934,Nov 13 2019,African Nations Cup qualifier in Namibia,Namibia,Chad,1337,1237,2,1,10,-10,1347,1227,117,152,4,-2,121,150,40,100,200
935,Nov 13 2019,African Nations Cup qualifier in Nigeria,Nigeria,Benin,1697,1460,2,1,5,-5,1702,1455,39,96,2,-2,41,94,40,100,337
936,Nov 13 2019,African Nations Cup qualifier in Senegal,Senegal,Congo,1759,1377,2,0,4,-4,1763,1373,29,112,1,0,30,112,30,0,382
937,Nov 13 2019,African Nations Cup qualifier in Sierra Leone,Sierra Leone,Lesotho,1351,1300,1,1,-8,8,1343,1308,127,130,-3,2,124,132,40,100,151
938,Nov 13 2019,African Nations Cup qualifier in Sudan,Sudan,SÃ£o TomÃ© and PrÃ­ncipe,1266,1109,4,0,14,-14,1280,1095,138,180,3,0,141,180,40,100,257
939,Nov 14 2019,World Cup & Asian Cup qual in Tajikistan,Afghanistan,India,1134,1197,1,1,4,-4,1138,1193,174,165,1,-3,175,162,40,0,-63
940,Nov 14 2019,European Championship qual in Albania,Albania,Andorra,1555,1088,2,2,-19,19,1536,1107,72,179,-2,1,70,180,40,100,567
941,Nov 14 2019,African Nations Cup qualifier in Algeria,Algeria,Zambia,1732,1467,5,0,9,-9,1741,1458,30,93,3,-1,33,92,40,100,365
942,Nov 14 2019,CONCACAF Nations League C in the Bahamas,Bahamas,British Virgin Islands,891,618,3,0,7,-7,898,611,201,229,0,0,201,229,40,100,373
943,Nov 14 2019,CONCACAF Nations League B in Belize,Belize,French Guiana,1116,1279,2,0,35,-35,1151,1244,165,152,7,-5,172,147,40,100,-63
944,Nov 14 2019,Friendly in Bulgaria,Bulgaria,Paraguay,1557,1734,0,1,-8,8,1549,1742,69,29,-1,3,68,32,20,100,-77
945,Nov 14 2019,Friendly in Cambodia,Cambodia,Mongolia,847,727,1,1,-6,6,841,733,205,214,0,1,205,215,20,100,220
946,Nov 14 2019,CONCACAF Nations League A in CuraÃ§ao,CuraÃ§ao,Costa Rica,1427,1657,1,2,-13,13,1414,1670,108,44,-5,2,103,46,40,100,-130
947,Nov 14 2019,European Championship qual in Czechia,Czechia,Kosovo,1755,1584,2,1,7,-7,1762,1577,26,62,3,0,29,62,40,100,271
948,Nov 14 2019,African Nations Cup qualifier in the Dem Rep of the Congo,DR Congo,Gabon,1518,1441,0,0,-9,9,1509,1450,83,95,-4,0,79,95,40,100,177
949,Nov 14 2019,Friendly in Ecuador,Ecuador,Trinidad and Tobago,1728,1356,3,0,2,-2,1730,1354,37,118,0,0,37,118,20,100,472
950,Nov 14 2019,African Nations Cup qualifier in Egypt,Egypt,Kenya,1615,1372,1,1,-15,15,1600,1387,59,105,-2,4,57,109,40,100,343
951,Nov 14 2019,European Championship qual in England,England,Montenegro,1939,1517,7,0,4,-4,1943,1513,12,79,0,-1,12,78,20,0,422
952,Nov 14 2019,European Championship qual in France,France,Moldova,2042,1245,2,1,0,0,2042,1245,3,145,0,1,3,146,20,0,797
953,Nov 14 2019,African Nations Cup qualifier in Ghana,Ghana,South Africa,1614,1545,2,0,16,-16,1630,1529,48,73,4,-1,52,72,40,100,169
954,Nov 14 2019,World Cup & Asian Cup qual in Hong Kong,Hong Kong,Bahrain,1168,1513,0,0,12,-12,1180,1501,164,84,1,-3,165,81,40,100,-245
955,Nov 14 2019,World Cup & Asian Cup qual in Jordan,Iraq,Iran,1573,1769,2,1,30,-30,1603,1739,49,42,7,-7,56,35,40,0,-196
956,Nov 14 2019,Friendly in Ireland,Ireland,New Zealand,1721,1503,3,1,4,-4,1725,1499,38,83,0,-1,38,82,20,100,318
957,Nov 14 2019,World Cup & Asian Cup qual in Jordan,Jordan,Australia,1487,1698,0,1,-14,14,1473,1712,93,39,-5,2,88,41,40,100,-111
958,Nov 14 2019,World Cup & Asian Cup qual in Kuwait,Kuwait,Taiwan,1416,946,9,0,4,-4,1420,942,96,193,3,1,99,194,40,100,570
959,Nov 14 2019,World Cup & Asian Cup qual in Kyrgyzstan,Kyrgyzstan,Japan,1285,1764,0,2,-6,6,1279,1770,142,23,-2,3,140,26,40,100,-379
960,Nov 14 2019,World Cup & Asian Cup qual in Lebanon,Lebanon,South Korea,1399,1770,0,0,13,-13,1412,1757,104,36,1,-5,105,31,40,100,-271
961,Nov 14 2019,World Cup & Asian Cup qual in Malaysia,Malaysia,Thailand,1156,1376,2,1,27,-27,1183,1349,159,129,5,-9,164,120,40,100,-120
962,Nov 14 2019,World Cup & Asian Cup qual in the Maldives,Maldives,Philippines,953,1142,1,2,-15,15,938,1157,196,170,-1,1,195,171,40,100,-89
963,Nov 14 2019,African Nations Cup qualifier in Mali,Mali,Guinea,1534,1406,2,2,-12,12,1522,1418,75,96,-1,4,74,100,40,100,228
964,Nov 14 2019,CONCACAF Nations League A in Martinique,Martinique,Honduras,1441,1627,1,1,5,-5,1446,1622,97,56,-1,-2,96,54,20,0,-186
965,Nov 14 2019,African Nations Cup qualifier in Mozambique,Mozambique,Rwanda,1314,1285,2,0,19,-19,1333,1266,119,148,6,-5,125,143,40,100,129
966,Nov 14 2019,World Cup & Asian Cup qual in Myanmar,Myanmar,Tajikistan,1017,1252,4,3,27,-27,1044,1225,185,160,1,-7,186,153,40,100,-135
967,Nov 14 2019,World Cup & Asian Cup qual in Oman,Oman,Bangladesh,1513,832,4,1,1,-1,1514,831,76,206,1,0,77,206,20,0,681
968,Nov 14 2019,European Championship qual in Portugal,Portugal,Lithuania,1982,1308,6,0,1,-1,1983,1307,6,132,0,0,6,132,20,0,674
969,Nov 14 2019,Friendly in Qatar,Qatar,Singapore,1721,1135,2,0,1,-1,1722,1134,40,180,-1,-3,39,177,20,0,586
970,Nov 14 2019,European Championship qual in Serbia,Serbia,Luxembourg,1791,1344,3,2,2,-2,1793,1342,23,125,0,-1,23,124,30,0,447
971,Nov 14 2019,CONCACAF Nations League B in Saint Kitts and Nevis,Saint Kitts and Nevis,Grenada,1225,1194,0,0,-7,7,1218,1201,159,156,-3,3,156,159,40,100,131
972,Nov 14 2019,World Cup & Asian Cup qual in the United Arab Emirates,Syria,China,1457,1481,2,1,21,-21,1478,1460,80,95,6,-4,86,91,40,0,-24
973,Nov 14 2019,African Nations Cup qualifier in Togo,Togo,Comoros,1340,1139,0,1,-34,34,1306,1173,141,161,-8,6,133,167,40,100,301
974,Nov 14 2019,European Championship qual in Turkey,Turkey,Iceland,1789,1655,0,0,-12,12,1777,1667,24,45,0,2,24,47,40,100,234
975,Nov 14 2019,World Cup & Asian Cup qual in Turkmenistan,Turkmenistan,North Korea,1227,1404,3,1,37,-37,1264,1367,138,125,6,-10,144,115,40,100,-77
976,Nov 14 2019,CONCACAF Nations League C in Turks and Caicos Islands,Turks and Caicos Islands,Sint Maarten,794,781,3,2,14,-14,808,767,208,213,1,-1,209,212,30,0,13
977,Nov 14 2019,Friendly in Ukraine,Ukraine,Estonia,1852,1437,1,0,1,-1,1853,1436,18,97,0,0,18,97,20,100,515
978,Nov 14 2019,World Cup & Asian Cup qual in Uzbekistan,Uzbekistan,Saudi Arabia,1599,1484,2,3,-31,31,1568,1515,73,67,-8,9,65,76,40,100,215
979,Nov 14 2019,World Cup & Asian Cup qual in Vietnam,Vietnam,United Arab Emirates,1398,1481,1,0,19,-19,1417,1462,95,93,6,-3,101,90,30,0,-83
980,Nov 14 2019,World Cup & Asian Cup qual in Bahrain,Yemen,Palestine,1200,1422,1,0,31,-31,1231,1391,138,114,10,-7,148,107,40,0,-222
981,Nov 15 2019,CONCACAF Nations League B in Antigua and Barbuda,Antigua and Barbuda,Jamaica,1162,1592,0,2,-8,8,1154,1600,173,56,-2,2,171,58,40,100,-330
982,Nov 15 2019,Friendly in Saudi Arabia,Argentina,Brazil,1953,2091,1,0,14,-14,1967,2077,6,1,2,0,8,1,20,0,-138
983,Nov 15 2019,European Championship qual in Armenia,Armenia,Greece,1474,1569,0,1,-20,20,1454,1589,99,58,-6,3,93,61,40,100,5
984,Nov 15 2019,European Championship qual in Bosnia and Herzegovina,Bosnia and Herzegovina,Italy,1699,1945,0,3,-21,21,1678,1966,45,9,-1,1,44,10,40,100,-146
985,Nov 15 2019,Friendly in the United States,Colombia,Peru,1974,1873,1,0,7,-7,1981,1866,7,17,0,0,7,17,20,0,101
986,Nov 15 2019,European Championship qual in Denmark,Denmark,Gibraltar,1895,1088,6,0,0,0,1895,1088,18,182,-2,0,16,182,20,0,807
987,Nov 15 2019,European Championship qual in Finland,Finland,Liechtenstein,1665,1149,3,0,2,-2,1667,1147,46,174,1,0,47,174,20,0,516
988,Nov 15 2019,CONCACAF Nations League B in Guyana,Guyana,Aruba,1196,906,4,2,6,-6,1202,900,160,201,0,-1,160,200,40,100,390
989,Nov 15 2019,Friendly in Hungary,Hungary,Uruguay,1635,1963,1,2,-4,4,1631,1967,51,8,0,0,51,8,20,100,-228
990,Nov 15 2019,African Nations Cup qualifier in Morocco,Morocco,Mauritania,1665,1345,0,0,-17,17,1648,1362,50,112,-1,5,49,117,40,100,420
991,Nov 15 2019,European Championship qual in Norway,Norway,Faroe Islands,1718,1229,4,0,2,-2,1720,1227,38,150,1,0,39,150,20,0,489
992,Nov 15 2019,CONCACAF Nations League A in Panama,Panama,Mexico,1518,1891,0,3,-12,12,1506,1903,83,12,-4,2,79,14,40,100,-273
993,Nov 15 2019,European Championship qual in Romania,Romania,Sweden,1739,1828,0,2,-31,31,1708,1859,49,17,-7,1,42,18,40,100,11
994,Nov 15 2019,European Championship qual in Spain,Spain,Malta,2021,1171,7,0,0,0,2021,1171,5,168,0,0,5,168,20,0,850
995,Nov 15 2019,CONCACAF Nations League B in St Vincent & Grenadines,St Vincent & Grenadines,Nicaragua,1189,1227,1,0,16,-16,1205,1211,153,163,5,-6,158,157,40,100,62
996,Nov 15 2019,CONCACAF Nations League B in Suriname,Suriname,Dominica,1285,1006,4,0,8,-8,1293,998,136,190,1,-1,137,189,40,100,379
997,Nov 15 2019,European Championship qual in Switzerland,Switzerland,Georgia,1894,1555,1,0,3,-3,1897,1552,15,67,0,0,15,67,40,100,439
998,Nov 15 2019,African Nations Cup qualifier in Tanzania,Tanzania,Equatorial Guinea,1322,1325,2,1,15,-15,1337,1310,121,132,4,-2,125,130,30,0,-3
999,Nov 15 2019,African Nations Cup qualifier in Tunisia,Tunisia,Libya,1597,1468,4,1,15,-15,1612,1453,52,99,3,-5,55,94,40,100,229
1000,Nov 15 2019,CONCACAF Nations League A in the United States,United States,Canada,1697,1623,4,1,19,-19,1716,1604,36,59,4,-3,40,56,40,100,174
1001,Nov 15 2019,African Nations Cup qualifier in Zimbabwe,Zimbabwe,Botswana,1394,1291,0,0,-11,11,1383,1302,114,132,-4,2,110,134,40,100,203
1002,Nov 16 2019,European Championship qual in Austria,Austria,North Macedonia,1773,1535,2,1,5,-5,1778,1530,25,71,0,0,25,71,40,100,338
1003,Nov 16 2019,European Championship qual in Azerbaijan,Azerbaijan,Wales,1391,1760,0,2,-11,11,1380,1771,114,24,-4,3,110,27,40,100,-269
1004,Nov 16 2019,CONCACAF Nations League C in the Cayman Islands,Cayman Islands,US Virgin Islands,920,731,1,0,6,-6,926,725,196,216,0,0,196,216,40,100,289
1005,Nov 16 2019,European Championship qual in Croatia,Croatia,Slovakia,1908,1741,3,1,11,-11,1919,1730,13,37,0,-2,13,35,40,100,267
1006,Nov 16 2019,European Championship qual in Cyprus,Cyprus,Scotland,1414,1621,1,2,-14,14,1400,1635,107,48,-2,3,105,51,40,100,-107
1007,Nov 16 2019,CONCACAF Nations League B in El Salvador,El Salvador,Montserrat,1483,819,1,0,0,0,1483,819,85,210,0,-1,85,209,20,0,664
1008,Nov 16 2019,European Championship qual in Germany,Germany,Belarus,1954,1506,4,0,3,-3,1957,1503,11,81,0,-1,11,80,20,0,448
1009,Nov 16 2019,CONCACAF Nations League C in Guatemala,Guatemala,Puerto Rico,1496,974,5,0,2,-2,1498,972,83,191,0,0,83,191,20,0,522
1010,Nov 16 2019,European Championship qual in Israel,Israel,Poland,1568,1770,1,2,-14,14,1554,1784,67,22,-1,2,66,24,40,100,-102
1011,Nov 16 2019,African Nations Cup qualifier in Ivory Coast,Ivory Coast,Niger,1648,1295,1,0,3,-3,1651,1292,49,138,0,-1,49,137,30,0,353
1012,Nov 16 2019,African Nations Cup qualifier in Madagascar,Madagascar,Ethiopia,1386,1260,1,0,9,-9,1395,1251,103,145,3,0,106,145,40,100,226
1013,Nov 16 2019,European Championship qual in Northern Ireland,Northern Ireland,Netherlands,1673,2029,0,0,13,-13,1686,2016,43,6,1,-1,44,5,40,100,-256
1014,Nov 16 2019,European Championship qual in Russia,Russia,Belgium,1814,2062,1,4,-21,21,1793,2083,24,0,-2,1,22,1,40,100,-148
1015,Nov 16 2019,European Championship qual in San Marino,San Marino,Kazakhstan,825,1363,1,3,-4,4,821,1367,209,114,-1,1,208,115,40,100,-438
1016,Nov 16 2019,European Championship qual in Slovenia,Slovenia,Latvia,1589,1220,1,0,3,-3,1592,1217,61,156,0,-1,61,155,30,0,369
1017,Nov 16 2019,CONCACAF Nations League B in Saint Lucia,Saint Lucia,Dominican Republic,1047,1212,1,0,24,-24,1071,1188,181,170,2,-7,183,163,40,100,-65
1018,Nov 16 2019,CONCACAF Nations League C in Anguilla,Saint Martin,Barbados,801,1128,1,0,35,-35,836,1093,202,184,4,-3,206,181,40,0,-327
1019,Nov 17 2019,European Championship qual in Albania,Albania,France,1536,2042,0,2,-5,5,1531,2047,74,3,-2,0,72,3,40,100,-406
1020,Nov 17 2019,European Championship qual in Andorra,Andorra,Turkey,1107,1777,0,2,-2,2,1105,1779,179,24,0,1,179,25,30,100,-570
1021,Nov 17 2019,CONCACAF Nations League C in CuraÃ§ao,Bahamas,Bonaire,898,964,1,1,4,-4,902,960,199,194,1,-1,200,193,40,0,-66
1022,Nov 17 2019,African Nations Cup qualifier in Benin,Benin,Sierra Leone,1455,1343,1,0,9,-9,1464,1334,84,125,4,-1,88,124,40,100,212
1023,Nov 17 2019,European Championship qual in Bulgaria,Bulgaria,Czechia,1549,1762,1,0,26,-26,1575,1736,60,38,4,-4,64,34,40,100,-113
1024,Nov 17 2019,African Nations Cup qualifier in Sudan,Burkina Faso,South Sudan,1526,1060,2,1,3,-3,1529,1057,75,186,-1,-1,74,185,40,0,466
1025,Nov 17 2019,African Nations Cup qualifier in Chad,Chad,Mali,1227,1522,0,2,-15,15,1212,1537,160,66,-5,4,155,70,40,100,-195
1026,Nov 17 2019,African Nations Cup qualifier in Congo,Congo,Guinea-Bissau,1373,1315,3,0,20,-20,1393,1295,103,141,4,-6,107,135,40,100,158
1027,Nov 17 2019,CONCACAF Nations League A in Costa Rica,Costa Rica,Haiti,1670,1547,1,1,-11,11,1659,1558,50,65,-2,2,48,67,40,100,223
1028,Nov 17 2019,African Nations Cup qualifier in Eswatini,Eswatini,Senegal,1126,1763,1,4,-3,3,1123,1766,178,29,0,0,178,29,40,100,-537
1029,Nov 17 2019,CONCACAF Nations League B in French Guiana,French Guiana,Saint Kitts and Nevis,1244,1218,3,1,20,-20,1264,1198,139,166,4,-6,143,160,40,100,126
1030,Nov 17 2019,African Nations Cup qualifier in Gabon,Gabon,Angola,1450,1352,2,1,10,-10,1460,1342,85,122,5,-1,90,121,40,100,198
1031,Nov 17 2019,CONCACAF Nations League B in Grenada,Grenada,Belize,1201,1151,3,2,12,-12,1213,1139,148,176,6,-2,154,174,40,100,150
1032,Nov 17 2019,CONCACAF Nations League C in Guadeloupe,Guadeloupe,Turks and Caicos Islands,1203,808,10,0,6,-6,1209,802,156,210,1,0,157,210,40,100,495
1033,Nov 17 2019,African Nations Cup qualifier in Guinea,Guinea,Namibia,1418,1347,2,0,16,-16,1434,1331,96,130,2,-4,98,126,40,100,171
1034,Nov 17 2019,CONCACAF Nations League A in Honduras,Honduras,Trinidad and Tobago,1622,1354,4,0,8,-8,1630,1346,52,119,1,0,53,119,40,100,368
1035,Nov 17 2019,European Championship qual in Kosovo,Kosovo,England,1577,1943,0,4,-13,13,1564,1956,69,12,-3,0,66,12,40,100,-266
1036,Nov 17 2019,African Nations Cup qualifier in Lesotho,Lesotho,Nigeria,1308,1702,2,4,-9,9,1299,1711,137,41,-3,1,134,42,40,100,-294
1037,Nov 17 2019,Friendly in Lithuania,Lithuania,New Zealand,1307,1499,1,0,13,-13,1320,1486,126,86,3,-2,129,84,20,100,-92
1038,Nov 17 2019,European Championship qual in Luxembourg,Luxembourg,Portugal,1342,1983,0,2,-3,3,1339,1986,120,6,2,0,122,6,40,100,-541
1039,Nov 17 2019,European Championship qual in Moldova,Moldova,Iceland,1245,1667,1,2,-5,5,1240,1672,148,45,-1,1,147,46,40,100,-322
1040,Nov 17 2019,African Nations Cup qualifier in Rwanda,Rwanda,Cameroon,1266,1571,0,1,-9,9,1257,1580,147,62,-2,1,145,63,40,100,-205
1041,Nov 17 2019,European Championship qual in Serbia,Serbia,Ukraine,1793,1853,2,2,-2,2,1791,1855,24,19,-1,0,23,19,30,100,40
1042,Nov 17 2019,African Nations Cup qualifier in South Africa,South Africa,Sudan,1529,1280,1,0,5,-5,1534,1275,70,141,1,-1,71,140,40,100,349
1043,Nov 17 2019,African Nations Cup qualifier in Uganda,Uganda,Malawi,1486,1356,2,0,13,-13,1499,1343,80,122,2,-2,82,120,40,100,230
1044,Nov 18 2019,CONCACAF Nations League B in CuraÃ§ao,Antigua and Barbuda,Aruba,1154,900,3,2,8,-8,1162,892,167,201,2,0,169,201,40,0,254
1045,Nov 18 2019,Friendly in Israel,Argentina,Uruguay,1967,1967,2,2,0,0,1967,1967,10,10,-1,-1,9,9,20,0,0
1046,Nov 18 2019,African Nations Cup qualifier in Botswana,Botswana,Algeria,1302,1741,0,1,-5,5,1297,1746,138,30,-3,1,135,31,40,100,-339
1047,Nov 18 2019,African Nations Cup qualifier in Cape Verde,Cape Verde,Mozambique,1417,1333,2,2,-10,10,1407,1343,107,115,-3,5,104,120,40,100,184
1048,Nov 18 2019,African Nations Cup qualifier in the Comoros,Comoros,Egypt,1173,1600,0,0,15,-15,1188,1585,157,64,5,-3,162,61,40,100,-327
1049,Nov 18 2019,CONCACAF Nations League B in Dominica,Dominica,St Vincent & Grenadines,998,1205,1,0,26,-26,1024,1179,187,174,1,-8,188,166,40,100,-107
1050,Nov 18 2019,African Nations Cup qualifier in The Gambia,Gambia,DR Congo,1331,1509,2,2,4,-4,1335,1505,124,80,1,-1,125,79,40,100,-78
1051,Nov 18 2019,European Championship qual in Gibraltar,Gibraltar,Switzerland,1088,1897,1,6,-1,1,1087,1898,182,15,0,0,182,15,20,100,-709
1052,Nov 18 2019,European Championship qual in Greece,Greece,Finland,1589,1667,2,1,19,-19,1608,1648,50,51,6,-2,56,49,40,100,22
1053,Nov 18 2019,European Championship qual in Ireland,Ireland,Denmark,1725,1895,1,1,4,-4,1729,1891,37,16,0,0,37,16,40,100,-70
1054,Nov 18 2019,European Championship qual in Italy,Italy,Armenia,1966,1454,9,1,3,-3,1969,1451,6,96,2,-1,8,95,40,100,612
1055,Nov 18 2019,CONCACAF Nations League B in Jamaica,Jamaica,Guyana,1600,1202,1,1,-18,18,1582,1220,66,147,-4,6,62,153,40,100,498
1056,Nov 18 2019,African Nations Cup qualifier in Kenya,Kenya,Togo,1387,1306,1,1,-10,10,1377,1316,113,129,-2,1,111,130,40,100,181
1057,Nov 18 2019,European Championship qual in Liechtenstein,Liechtenstein,Bosnia and Herzegovina,1147,1678,0,3,-5,5,1142,1683,173,45,0,0,173,45,40,100,-431
1058,Nov 18 2019,European Championship qual in Malta,Malta,Norway,1171,1720,1,2,-3,3,1168,1723,168,37,0,1,168,38,40,100,-449
1059,Nov 18 2019,CONCACAF Nations League B in Nicaragua,Nicaragua,Suriname,1211,1293,1,2,-21,21,1190,1314,166,126,-5,5,161,131,40,100,18
1060,Nov 18 2019,African Nations Cup qualifier in SÃ£o TomÃ© and PrÃ­ncipe,SÃ£o TomÃ© and PrÃ­ncipe,Ghana,1095,1630,0,1,-3,3,1092,1633,182,51,-1,1,181,52,40,100,-435
1061,Nov 18 2019,European Championship qual in Spain,Spain,Romania,2021,1708,5,0,7,-7,2028,1701,4,43,0,0,4,43,40,100,413
1062,Nov 18 2019,European Championship qual in Sweden,Sweden,Faroe Islands,1859,1227,3,0,1,-1,1860,1226,18,150,0,0,18,150,20,0,632
1063,Nov 19 2019,World Cup & Asian Cup qual in Jordan,Bahrain,Iraq,1501,1603,0,0,6,-6,1507,1597,75,58,3,0,78,58,40,0,-102
1064,Nov 19 2019,CONCACAF Nations League C in Barbados,Barbados,Cayman Islands,1093,926,3,0,12,-12,1105,914,178,198,1,-1,179,197,40,100,267
1065,Nov 19 2019,European Championship qual in Belgium,Belgium,Cyprus,2083,1400,6,1,1,-1,2084,1399,1,109,0,-2,1,107,20,0,683
1066,Nov 19 2019,Friendly in the United Arab Emirates,Brazil,South Korea,2077,1757,3,0,5,-5,2082,1752,2,26,0,2,2,28,20,0,320
1067,Nov 19 2019,African Nations Cup qualifier in Burundi,Burundi,Morocco,1287,1648,0,3,-13,13,1274,1661,140,45,-1,2,139,47,40,100,-261
1068,Nov 19 2019,Friendly in the United States,Colombia,Ecuador,1981,1730,1,0,4,-4,1985,1726,7,39,0,-2,7,37,20,0,251
1069,Nov 19 2019,Friendly in Croatia,Croatia,Georgia,1919,1552,2,1,1,-1,1920,1551,13,67,0,1,13,68,20,100,467
1070,Nov 19 2019,CONCACAF Nations League B in El Salvador,El Salvador,Dominican Republic,1483,1188,2,0,6,-6,1489,1182,83,168,1,-3,84,165,40,100,395
1071,Nov 19 2019,African Nations Cup qualifier in Equatorial Guinea,Equatorial Guinea,Tunisia,1310,1612,0,1,-10,10,1300,1622,134,51,-1,2,133,53,40,100,-202
1072,Nov 19 2019,African Nations Cup qualifier in Ethiopia,Ethiopia,Ivory Coast,1251,1651,2,1,34,-34,1285,1617,128,62,9,-7,137,55,40,100,-300
1073,Nov 19 2019,European Championship qual in Germany,Germany,Northern Ireland,1957,1686,6,1,8,-8,1965,1678,11,46,0,-1,11,45,40,100,371
1074,Nov 19 2019,World Cup & Asian Cup qual in Hong Kong,Hong Kong,Cambodia,1180,841,2,0,4,-4,1184,837,163,209,1,-2,164,207,20,0,339
1075,Nov 19 2019,Friendly in Japan,Japan,Venezuela,1770,1809,1,4,-21,21,1749,1830,30,20,-1,0,29,20,20,100,61
1076,Nov 19 2019,World Cup & Asian Cup qual in Jordan,Jordan,Taiwan,1473,942,5,0,2,-2,1475,940,87,196,0,-1,87,195,20,0,531
1077,Nov 19 2019,World Cup & Asian Cup qual in Bhutan,Kuwait,Nepal,1420,919,1,0,2,-2,1422,917,102,195,-1,1,101,196,30,0,501
1078,Nov 19 2019,World Cup & Asian Cup qual in Kyrgyzstan,Kyrgyzstan,Tajikistan,1279,1225,1,1,-8,8,1271,1233,141,147,-1,2,140,149,40,100,154
1079,Nov 19 2019,European Championship qual in Latvia,Latvia,Austria,1217,1778,1,0,37,-37,1254,1741,140,36,7,-5,147,31,40,100,-461
1080,Nov 19 2019,World Cup & Asian Cup qual in Lebanon,Lebanon,North Korea,1412,1367,0,0,-8,8,1404,1375,109,111,-3,2,106,113,40,100,145
1081,Nov 19 2019,African Nations Cup qualifier in Tunisia,Libya,Tanzania,1453,1337,2,1,14,-14,1467,1323,82,132,6,-4,88,128,40,0,116
1082,Nov 19 2019,World Cup & Asian Cup qual in Malaysia,Malaysia,Indonesia,1183,1135,2,0,18,-18,1201,1117,152,180,6,-2,158,178,40,100,148
1083,Nov 19 2019,World Cup & Asian Cup qual in the Maldives,Maldives,Guam,938,743,3,1,9,-9,947,734,193,215,1,-1,194,214,40,100,295
1084,Nov 19 2019,African Nations Cup qualifier in Mauritania,Mauritania,Central African Republic,1362,1370,2,0,22,-22,1384,1348,101,123,8,-5,109,118,40,100,92
1085,Nov 19 2019,CONCACAF Nations League A in Mexico,Mexico,Bermuda,1903,1302,2,1,1,-1,1904,1301,14,131,0,1,14,132,20,0,601
1086,Nov 19 2019,Friendly in Montenegro,Montenegro,Belarus,1513,1503,2,0,10,-10,1523,1493,73,86,2,-3,75,83,20,100,110
1087,Nov 19 2019,World Cup & Asian Cup qual in Myanmar,Myanmar,Mongolia,1044,733,1,0,3,-3,1047,730,184,215,1,0,185,215,20,0,311
1088,Nov 19 2019,European Championship qual in the Netherlands,Netherlands,Estonia,2016,1436,5,0,2,-2,2018,1434,5,95,0,1,5,96,30,0,580
1089,Nov 19 2019,African Nations Cup qualifier in Niger,Niger,Madagascar,1292,1395,2,6,-37,37,1255,1432,155,90,-9,8,146,98,40,100,-3
1090,Nov 19 2019,European Championship qual in North Macedonia,North Macedonia,Israel,1530,1554,1,0,16,-16,1546,1538,65,72,4,-2,69,70,30,0,-24
1091,Nov 19 2019,World Cup & Asian Cup qual in Oman,Oman,India,1514,1193,1,0,3,-3,1517,1190,78,162,-1,-1,77,161,20,0,321
1092,Nov 19 2019,European Championship qual in Poland,Poland,Slovenia,1784,1592,3,2,6,-6,1790,1586,24,60,0,0,24,60,40,100,292
1093,Nov 19 2019,CONCACAF Nations League C in Puerto Rico,Puerto Rico,Anguilla,972,555,3,0,3,-3,975,552,191,233,0,0,191,233,20,0,417
1094,Nov 19 2019,World Cup & Asian Cup qual in Tajikistan,Qatar,Afghanistan,1722,1138,1,0,1,-1,1723,1137,37,177,1,-1,38,176,20,0,584
1095,Nov 19 2019,European Championship qual in San Marino,San Marino,Russia,821,1793,0,5,-1,1,820,1794,210,22,-1,0,209,22,40,100,-872
1096,Nov 19 2019,Friendly in Saudi Arabia,Saudi Arabia,Paraguay,1515,1742,0,0,4,-4,1519,1738,77,34,-1,-1,76,33,20,100,-127
1097,Nov 19 2019,European Championship qual in Scotland,Scotland,Kazakhstan,1635,1367,3,1,6,-6,1641,1361,49,117,1,-1,50,116,40,100,368
1098,Nov 19 2019,World Cup & Asian Cup qual in Bahrain,Singapore,Yemen,1134,1231,2,1,25,-25,1159,1206,165,166,6,-9,171,157,40,0,-97
1099,Nov 19 2019,European Championship qual in Slovakia,Slovakia,Azerbaijan,1730,1380,2,0,4,-4,1734,1376,35,114,0,-2,35,112,20,0,350
1100,Nov 19 2019,CONCACAF Nations League B in Saint Lucia,Saint Lucia,Montserrat,1071,819,0,1,-35,35,1036,854,189,203,-3,3,186,206,40,100,352
1101,Nov 19 2019,World Cup & Asian Cup qual in the United Arab Emirates,Syria,Philippines,1478,1157,1,0,5,-5,1483,1152,86,173,0,-1,86,172,40,0,321
1102,Nov 19 2019,World Cup & Asian Cup qual in Turkmenistan,Turkmenistan,Sri Lanka,1264,670,2,0,1,-1,1265,669,143,225,0,0,143,225,20,0,594
1103,Nov 19 2019,CONCACAF Nations League A in the Cayman Islands,United States,Cuba,1716,1274,4,0,5,-5,1721,1269,40,143,0,-1,40,142,40,0,442
1104,Nov 19 2019,CONCACAF Nations League C in the US Virgin Islands,US Virgin Islands,Saint Martin,725,836,1,2,-19,19,706,855,218,204,-1,1,217,205,40,100,-11
1105,Nov 19 2019,World Cup & Asian Cup qual in Uzbekistan,Uzbekistan,Palestine,1568,1391,2,0,10,-10,1578,1381,63,112,1,-2,64,110,40,100,277
1106,Nov 19 2019,World Cup & Asian Cup qual in Vietnam,Vietnam,Thailand,1417,1349,0,0,-9,9,1408,1358,107,116,-3,1,104,117,40,100,168
1107,Nov 19 2019,European Championship qual in Wales,Wales,Hungary,1771,1631,2,0,12,-12,1783,1619,23,55,2,-1,25,54,40,100,240
1108,Nov 19 2019,African Nations Cup qualifier in Zambia,Zambia,Zimbabwe,1458,1383,1,2,-29,29,1429,1412,106,97,-7,6,99,103,40,100,175
1109,Nov 21 2019,Friendly in Guatemala,Guatemala,Antigua and Barbuda,1498,1162,8,0,4,-4,1502,1158,80,173,1,-2,81,171,20,100,436
1110,Nov 26 2019,Gulf Cup in Qatar,Qatar,Iraq,1723,1597,1,2,-31,31,1692,1628,48,48,-5,5,43,53,40,100,226
1111,Nov 26 2019,Gulf Cup in Qatar,United Arab Emirates,Yemen,1462,1206,3,0,13,-13,1475,1193,84,163,3,-3,87,160,40,0,256
1112,Nov 27 2019,Gulf Cup in Qatar,Bahrain,Oman,1507,1517,0,0,1,-1,1508,1516,76,75,1,1,77,76,40,0,-10
1113,Nov 27 2019,Gulf Cup in Qatar,Kuwait,Saudi Arabia,1422,1519,3,1,38,-38,1460,1481,81,96,10,-10,91,86,40,0,-97
1114,Nov 29 2019,Gulf Cup in Qatar,Iraq,United Arab Emirates,1628,1475,2,0,18,-18,1646,1457,47,99,3,-6,50,93,40,0,153
1115,Nov 29 2019,Gulf Cup in Qatar,Qatar,Yemen,1692,1193,6,0,3,-3,1695,1190,43,160,0,0,43,160,30,0,499
1116,Nov 30 2019,Gulf Cup in Qatar,Oman,Kuwait,1516,1460,2,1,17,-17,1533,1443,70,102,3,-6,73,96,40,0,56
1117,Nov 30 2019,Gulf Cup in Qatar,Saudi Arabia,Bahrain,1481,1508,2,0,32,-32,1513,1476,68,95,9,-9,77,86,40,0,-27
1118,Dec 2 2019,Gulf Cup in Qatar,Bahrain,Kuwait,1476,1443,4,2,27,-27,1503,1416,72,106,7,-5,79,101,40,0,33
1119,Dec 2 2019,Gulf Cup in Qatar,Iraq,Yemen,1646,1190,0,0,-17,17,1629,1207,56,154,-3,3,53,157,40,0,456
1120,Dec 2 2019,Gulf Cup in Qatar,Qatar,United Arab Emirates,1695,1457,4,2,8,-8,1703,1449,41,96,1,-2,42,94,40,100,338
1121,Dec 2 2019,Gulf Cup in Qatar,Saudi Arabia,Oman,1513,1533,3,1,32,-32,1545,1501,63,89,7,-8,70,81,40,0,-20
1122,Dec 5 2019,Gulf Cup in Qatar,Bahrain,Iraq,1503,1629,2,2,7,-7,1510,1622,75,53,2,0,77,53,40,0,-126
1123,Dec 5 2019,Gulf Cup in Qatar,Qatar,Saudi Arabia,1703,1545,0,1,-33,33,1670,1578,50,58,-4,6,46,64,40,100,258
1124,Dec 7 2019,CECAFA Cup in Uganda,Djibouti,Somalia,886,876,0,0,-1,1,885,877,202,203,0,0,202,203,40,0,10
1125,Dec 7 2019,CECAFA Cup in Uganda,Uganda,Burundi,1499,1274,2,1,5,-5,1504,1269,78,143,2,-2,80,141,40,100,325
1126,Dec 8 2019,Gulf Cup in Qatar,Bahrain,Saudi Arabia,1510,1578,1,0,24,-24,1534,1554,69,72,4,-4,73,68,40,0,-68
1127,Dec 8 2019,CECAFA Cup in Uganda,Kenya,Tanzania,1377,1323,1,0,17,-17,1394,1306,105,134,3,-3,108,131,40,0,54
1128,Dec 8 2019,CECAFA Cup in Uganda,Sudan,Zanzibar,1275,1372,1,1,5,-5,1280,1367,138,116,0,-1,138,115,40,0,-97
1129,Dec 9 2019,CECAFA Cup in Uganda,Eritrea,Burundi,1060,1269,1,0,31,-31,1091,1238,181,155,1,-7,182,148,40,0,-209
1130,Dec 9 2019,CECAFA Cup in Uganda,Uganda,Somalia,1504,877,2,0,1,-1,1505,876,78,203,1,0,79,203,20,0,627
1131,Dec 10 2019,East Asian Championship in South Korea,Japan,China,1749,1460,2,1,6,-6,1755,1454,27,94,1,-2,28,92,40,0,289
1132,Dec 10 2019,CECAFA Cup in Uganda,Kenya,Sudan,1394,1280,2,1,14,-14,1408,1266,100,144,4,-3,104,141,40,0,114
1133,Dec 10 2019,CECAFA Cup in Uganda,Tanzania,Zanzibar,1306,1367,1,0,23,-23,1329,1344,123,123,4,-4,127,119,40,0,-61
1134,Dec 11 2019,CECAFA Cup in Uganda,Djibouti,Burundi,885,1238,2,1,35,-35,920,1203,190,166,6,-9,196,157,40,0,-353
1135,Dec 11 2019,East Asian Championship in South Korea,South Korea,Hong Kong,1752,1184,2,0,1,-1,1753,1183,29,164,0,0,29,164,20,0,568
1136,Dec 11 2019,CECAFA Cup in Uganda,Uganda,Eritrea,1505,1091,2,0,3,-3,1508,1088,77,182,1,0,78,182,20,0,414
1137,Dec 13 2019,CECAFA Cup in Uganda,Eritrea,Djibouti,1088,920,3,0,19,-19,1107,901,176,208,3,-6,179,202,40,0,168
1138,Dec 13 2019,CECAFA Cup in Uganda,Somalia,Burundi,876,1203,1,0,35,-35,911,1168,195,177,4,-10,199,167,40,0,-327
1139,Dec 14 2019,East Asian Championship in South Korea,Japan,Hong Kong,1755,1183,5,0,3,-3,1758,1180,28,165,0,-1,28,164,40,0,572
1140,Dec 14 2019,CECAFA Cup in Uganda,Kenya,Zanzibar,1408,1344,1,0,16,-16,1424,1328,96,135,4,-8,100,127,40,0,64
1141,Dec 14 2019,CECAFA Cup in Uganda,Sudan,Tanzania,1266,1329,0,0,4,-4,1270,1325,137,129,2,-1,139,128,40,0,-63
1142,Dec 15 2019,CECAFA Cup in Uganda,Eritrea,Somalia,1107,911,0,0,-10,10,1097,921,183,193,-2,3,181,196,30,100,296
1143,Dec 15 2019,East Asian Championship in South Korea,South Korea,China,1753,1454,1,0,4,-4,1757,1450,29,94,0,-1,29,93,40,100,399
1144,Dec 15 2019,CECAFA Cup in Uganda,Uganda,Djibouti,1508,901,4,1,1,-1,1509,900,78,202,0,0,78,202,20,0,607
1145,Dec 17 2019,CECAFA Cup in Uganda,Eritrea,Kenya,1097,1424,4,1,61,-61,1158,1363,161,128,10,-14,171,114,40,0,-327
1146,Dec 17 2019,CECAFA Cup in Uganda,Uganda,Tanzania,1509,1325,1,0,7,-7,1516,1318,78,130,0,-1,78,129,40,100,284
1147,Dec 18 2019,East Asian Championship in South Korea,China,Hong Kong,1450,1180,2,0,10,-10,1460,1170,87,168,3,-2,90,166,40,0,270
1148,Dec 18 2019,East Asian Championship in South Korea,South Korea,Japan,1757,1758,1,0,14,-14,1771,1744,25,32,2,-2,27,30,40,100,99
1149,Dec 19 2019,CECAFA Cup in Uganda,Kenya,Tanzania,1363,1318,2,1,17,-17,1380,1301,108,133,3,-2,111,131,40,0,45
1150,Dec 19 2019,CECAFA Cup in Uganda,Uganda,Eritrea,1516,1158,3,0,5,-5,1521,1153,78,173,0,-1,78,172,40,100,458
