,date,tournament,home_team,away_team,home_team_rating,away_team_rating,home_goals,away_goals,home_team_rating_change,away_team_rating_change,home_team_new_rating,away_team_new_rating,home_team_rank,away_team_rank,home_team_rank_change,away_team_rank_change,home_team_new_rank,away_team_new_rank,k,hadv,rdiff
0,Jan 2 1994,Friendly in Barbados,Barbados,Grenada,1321,1280,0,0,-4,4,1317,1284,124,135,-1,1,123,136,20,100,141
1,Jan 2 1994,Friendly in Ghana,Ghana,Egypt,1618,1659,2,1,8,-8,1626,1651,48,42,3,-2,51,40,20,100,59
2,Jan 5 1994,Friendly in Mali,Mali,Burkina Faso,1423,1415,1,1,-3,3,1420,1418,101,99,-2,1,99,100,20,100,108
3,Jan 9 1994,Friendly in Mauritania,Mauritania,Mali,1081,1420,1,3,-6,6,1075,1426,178,93,0,3,178,96,20,100,-239
4,Jan 11 1994,Friendly in Thailand,Thailand,Nigeria,1398,1703,1,1,5,-5,1403,1698,102,31,1,0,103,31,20,100,-205
5,Jan 15 1994,Friendly in the United States,United States,Norway,1619,1853,2,1,14,-14,1633,1839,42,21,6,-3,48,18,20,100,-134
6,Jan 18 1994,Friendly in Guinea,Guinea,Ivory Coast,1423,1628,3,0,23,-23,1446,1605,90,66,4,-8,94,58,20,100,-105
7,Jan 19 1994,Friendly in the United States,Bulgaria,Mexico,1788,1890,1,1,3,-3,1791,1887,24,10,0,0,24,10,20,0,-102
8,Jan 19 1994,Friendly in the United States,Costa Rica,Norway,1613,1839,0,0,6,-6,1619,1833,53,20,1,-1,54,19,20,0,-226
9,Jan 19 1994,Friendly in Spain,Spain,Portugal,1910,1828,2,2,-5,5,1905,1833,9,18,0,1,9,19,20,100,182
10,Jan 19 1994,Caribbean Cup qualifier in Suriname,Suriname,French Guiana,1334,1282,1,0,12,-12,1346,1270,112,139,3,-1,115,138,40,100,152
11,Jan 19 1994,Friendly in Tunisia,Tunisia,Netherlands,1643,1994,2,2,6,-6,1649,1988,37,3,5,0,42,3,20,100,-251
12,Jan 21 1994,Caribbean Cup qualifier in Suriname,French Guiana,Guyana,1270,1114,1,1,-8,8,1262,1122,140,168,-1,1,139,169,40,0,156
13,Jan 22 1994,Friendly in the United States,United States,Switzerland,1633,1847,1,1,3,-3,1636,1844,48,15,0,0,48,15,20,100,-114
14,Jan 23 1994,Caribbean Cup qualifier in Barbados,Barbados,Puerto Rico,1317,1060,0,1,-35,35,1282,1095,149,170,-13,5,136,175,40,100,357
15,Jan 23 1994,Friendly in Mali,Mali,Senegal,1426,1448,1,0,8,-8,1434,1440,95,95,1,-1,96,94,20,100,78
16,Jan 23 1994,Friendly in Saudi Arabia,Saudi Arabia,China,1683,1512,1,0,3,-3,1686,1509,34,77,0,-1,34,76,20,100,271
17,Jan 23 1994,Caribbean Cup qualifier in Suriname,Suriname,Guyana,1346,1122,2,0,8,-8,1354,1114,115,171,0,-1,115,170,40,100,324
18,Jan 25 1994,Caribbean Cup qualifier in Barbados,Grenada,Puerto Rico,1284,1095,1,0,10,-10,1294,1085,131,179,2,-2,133,177,40,0,189
19,Jan 25 1994,Friendly in Qatar,Qatar,Finland,1473,1559,1,0,10,-10,1483,1549,86,75,2,-5,88,70,20,100,14
20,Jan 26 1994,Friendly in Saudi Arabia,Saudi Arabia,China,1686,1509,1,1,-7,7,1679,1516,34,68,0,4,34,72,20,100,277
21,Jan 26 1994,Friendly in the United States,Switzerland,Mexico,1844,1887,5,1,21,-21,1865,1866,15,18,0,-4,15,14,20,0,-43
22,Jan 27 1994,Caribbean Cup qualifier in Barbados,Barbados,Grenada,1282,1294,3,2,15,-15,1297,1279,128,139,4,-3,132,136,40,100,88
23,Jan 27 1994,Friendly in Qatar,Qatar,Finland,1483,1549,0,0,-1,1,1482,1550,88,70,0,0,88,70,20,100,34
24,Jan 28 1994,Friendly in Venezuela,Venezuela,Colombia,1344,1932,1,2,-1,1,1343,1933,116,5,0,0,116,5,20,0,-588
25,Jan 29 1994,Black Stars Tournament in Burkina Faso,Burkina Faso,Guinea,1418,1446,1,1,-3,3,1415,1449,102,93,-1,0,101,93,30,100,72
26,Jan 29 1994,Black Stars Tournament in Burkina Faso,Ivory Coast,Niger,1605,1333,5,3,8,-8,1613,1325,54,122,2,-1,56,121,30,0,272
27,Jan 29 1994,Friendly in the United States,United States,Russia,1636,1841,1,1,3,-3,1639,1838,48,19,0,-1,48,18,20,100,-105
28,Jan 30 1994,Black Stars Tournament in Burkina Faso,Burkina Faso,Ivory Coast,1415,1613,0,1,-11,11,1404,1624,101,48,0,4,101,52,30,100,-98
29,Jan 30 1994,Black Stars Tournament in Burkina Faso,Niger,Guinea,1325,1449,3,1,30,-30,1355,1419,109,105,6,-6,115,99,30,0,-124
30,Jan 30 1994,Friendly in Oman,Oman,Finland,1150,1550,0,2,-5,5,1145,1555,165,64,-1,3,164,67,20,100,-300
31,Jan 30 1994,Friendly in Senegal,Senegal,Mali,1440,1434,0,0,-3,3,1437,1437,94,92,0,2,94,94,20,100,106
32,Feb 1 1994,Friendly in Oman,Oman,Finland,1145,1555,1,1,7,-7,1152,1548,162,73,1,-3,163,70,20,100,-310
33,Feb 2 1994,Friendly tournament in the United Arab Emirates,Egypt,Morocco,1651,1671,1,1,1,-1,1652,1670,40,37,0,-1,40,36,20,0,-20
34,Feb 2 1994,Friendly in the United States,Russia,Mexico,1838,1866,4,1,19,-19,1857,1847,12,18,3,-2,15,16,20,0,-28
35,Feb 2 1994,Friendly tournament in the United Arab Emirates,United Arab Emirates,Slovakia,1505,1662,0,1,-13,13,1492,1675,88,33,-5,2,83,35,30,100,-57
36,Feb 4 1994,Friendly tournament in the United Arab Emirates,Egypt,Slovakia,1652,1675,1,0,16,-16,1668,1659,32,41,4,-3,36,38,30,0,-23
37,Feb 4 1994,Friendly in Oman,Oman,Kenya,1152,1486,1,0,16,-16,1168,1470,157,96,3,-6,160,90,20,100,-234
38,Feb 4 1994,Friendly tournament in the United Arab Emirates,United Arab Emirates,Morocco,1492,1670,1,1,3,-3,1495,1667,81,38,1,-1,82,37,30,100,-78
39,Feb 6 1994,Friendly tournament in the United Arab Emirates,Morocco,Slovakia,1667,1659,2,1,15,-15,1682,1644,33,54,2,-8,35,46,30,0,8
40,Feb 6 1994,Friendly in Oman,Oman,Kenya,1168,1470,2,0,23,-23,1191,1447,156,94,2,-2,158,92,20,100,-202
41,Feb 6 1994,Friendly in Saudi Arabia,Saudi Arabia,Colombia,1679,1933,1,1,4,-4,1683,1929,34,9,0,-2,34,7,20,100,-154
42,Feb 6 1994,Friendly tournament in the United Arab Emirates,United Arab Emirates,Egypt,1495,1668,0,1,-12,12,1483,1680,90,36,-4,0,86,36,30,100,-73
43,Feb 7 1994,Friendly in The Gambia,Gambia,Senegal,1331,1437,0,0,0,0,1331,1437,121,94,0,0,121,94,20,100,-6
44,Feb 8 1994,Friendly tournament in Malta,Malta,Tunisia,1382,1649,1,1,7,-7,1389,1642,107,53,0,-6,107,47,30,100,-167
45,Feb 8 1994,Friendly tournament in Malta,Slovenia,Georgia,1556,1596,1,0,17,-17,1573,1579,60,62,3,-1,63,61,30,0,-40
46,Feb 9 1994,Friendly in Saudi Arabia,Saudi Arabia,Colombia,1683,1929,0,1,-6,6,1677,1935,38,3,-2,2,36,5,20,100,-146
47,Feb 9 1994,Friendly in Spain,Spain,Poland,1905,1692,1,1,-7,7,1898,1699,9,29,0,2,9,31,20,100,313
48,Feb 10 1994,Friendly tournament in Malta,Malta,Georgia,1389,1579,0,1,-11,11,1378,1590,109,61,-1,0,108,61,30,100,-90
49,Feb 10 1994,Friendly tournament in Malta,Slovenia,Tunisia,1573,1642,2,2,3,-3,1576,1639,63,47,0,0,63,47,30,0,-69
50,Feb 12 1994,Friendly tournament in Malta,Georgia,Tunisia,1590,1639,2,0,26,-26,1616,1613,49,67,6,-10,55,57,30,0,-49
51,Feb 12 1994,Friendly in Malawi,Malawi,Zambia,1432,1649,0,3,-12,12,1420,1661,100,35,-2,3,98,38,20,100,-117
52,Feb 12 1994,Friendly tournament in Malta,Malta,Slovenia,1378,1576,0,1,-11,11,1367,1587,116,61,-4,1,112,62,30,100,-98
53,Feb 13 1994,Friendly in Malawi,Malawi,Zambia,1420,1661,0,2,-9,9,1411,1670,102,36,-2,1,100,37,20,100,-141
54,Feb 13 1994,Friendly tournament in Hong Kong,Romania,United States,1828,1639,2,1,8,-8,1836,1631,17,47,2,0,19,47,30,0,189
55,Feb 16 1994,Friendly in Italy,Italy,France,1999,1886,0,1,-15,15,1984,1901,4,8,-1,1,3,9,20,100,213
56,Feb 16 1994,Friendly in Malta,Malta,Belgium,1367,1826,1,0,18,-18,1385,1808,102,22,5,0,107,22,20,100,-359
57,Feb 16 1994,Friendly in South Korea,South Korea,Romania,1659,1836,1,2,-8,8,1651,1844,41,15,-1,2,40,17,20,100,-77
58,Feb 18 1994,Friendly tournament in the United States,Colombia,Sweden,1935,1882,0,0,-2,2,1933,1884,5,11,0,0,5,11,20,0,53
59,Feb 18 1994,Friendly tournament in the United States,United States,Bolivia,1631,1704,1,1,-1,1,1630,1705,49,30,-1,0,48,30,20,100,27
60,Feb 20 1994,Friendly tournament in the United States,Colombia,Bolivia,1933,1705,2,0,10,-10,1943,1695,5,34,0,-2,5,32,30,0,228
61,Feb 20 1994,Friendly tournament in the United States,United States,Sweden,1630,1884,1,3,-13,13,1617,1897,60,11,-6,0,54,11,30,100,-154
62,Feb 23 1994,Caribbean Cup qualifier in Saint Kitts and Nevis,Dominica,Antigua and Barbuda,1138,1213,3,2,24,-24,1162,1189,161,165,2,-7,163,158,40,0,-75
63,Feb 23 1994,Friendly in Israel,Israel,Georgia,1561,1616,2,0,13,-13,1574,1603,63,63,1,-4,64,59,20,100,45
64,Feb 23 1994,Friendly in Mali,Mali,Ghana,1437,1626,0,0,3,-3,1440,1623,92,51,1,-1,93,50,20,100,-89
65,Feb 23 1994,Friendly in Morocco,Morocco,Finland,1682,1548,0,0,-6,6,1676,1554,38,64,-2,3,36,67,20,100,234
66,Feb 23 1994,Caribbean Cup qualifier in Saint Kitts and Nevis,Saint Kitts and Nevis,Montserrat,1168,588,9,1,2,-2,1170,586,161,217,0,0,161,217,20,0,580
67,Feb 23 1994,Friendly in Turkey,Turkey,Czechia,1593,1844,1,4,-10,10,1583,1854,63,15,-1,1,62,16,20,100,-151
68,Feb 24 1994,Friendly in the United States,Mexico,Sweden,1847,1897,2,1,11,-11,1858,1886,13,11,2,0,15,11,20,0,-50
69,Feb 25 1994,Caribbean Cup qualifier in Saint Kitts and Nevis,Antigua and Barbuda,Montserrat,1189,586,8,0,3,-3,1192,583,156,217,1,0,157,217,40,0,603
70,Feb 25 1994,Caribbean Cup qualifier in Saint Kitts and Nevis,Saint Kitts and Nevis,Dominica,1170,1162,2,3,-26,26,1144,1188,169,155,-4,4,165,159,40,100,108
71,Feb 26 1994,Friendly in the United States,Colombia,South Korea,1943,1651,2,2,-7,7,1936,1658,5,38,0,1,5,39,20,0,292
72,Feb 26 1994,Friendly in Zimbabwe,Zimbabwe,Zambia,1557,1670,2,2,0,0,1557,1670,66,37,0,0,66,37,20,100,-13
73,Feb 27 1994,Friendly in Gabon,Gabon,Senegal,1438,1437,0,0,-3,3,1435,1440,96,91,-1,2,95,93,20,100,101
74,Mar 2 1994,Caribbean Cup qualifier in the Cayman Islands,Cayman Islands,British Virgin Islands,950,874,5,0,21,-21,971,853,189,209,2,-4,191,205,40,100,176
75,Mar 2 1994,Caribbean Cup qualifier in the Cayman Islands,Jamaica,Sint Maarten,1482,951,3,2,2,-2,1484,949,81,194,3,-1,84,193,40,0,531
76,Mar 2 1994,Friendly in Mexico,Mexico,Colombia,1858,1936,0,0,-1,1,1857,1937,15,5,0,0,15,5,20,100,22
77,Mar 4 1994,Caribbean Cup qualifier in the Cayman Islands,Cayman Islands,Sint Maarten,971,949,5,0,27,-27,998,922,191,195,0,-1,191,194,40,100,122
78,Mar 4 1994,Caribbean Cup qualifier in St Vincent & Grenadines,Guadeloupe,Anguilla,1315,563,9,0,1,-1,1316,562,123,219,0,0,123,219,20,0,752
79,Mar 4 1994,Caribbean Cup qualifier in the Cayman Islands,Jamaica,British Virgin Islands,1484,853,12,0,3,-3,1487,850,82,205,1,0,83,205,40,0,631
80,Mar 6 1994,Caribbean Cup qualifier in the Cayman Islands,Cayman Islands,Jamaica,998,1487,3,2,36,-36,1034,1451,175,97,8,-7,183,90,40,100,-389
81,Mar 6 1994,Caribbean Cup qualifier in the Cayman Islands,Sint Maarten,British Virgin Islands,922,850,3,0,28,-28,950,822,192,205,1,0,193,205,40,0,72
82,Mar 6 1994,Caribbean Cup qualifier in St Vincent & Grenadines,St Vincent & Grenadines,Anguilla,1296,562,2,0,0,0,1296,562,133,219,0,0,133,219,20,0,734
83,Mar 8 1994,Caribbean Cup qualifier in St Vincent & Grenadines,St Vincent & Grenadines,Guadeloupe,1296,1316,0,2,-37,37,1259,1353,145,111,-6,6,139,117,40,100,80
84,Mar 9 1994,Friendly in Cyprus,Cyprus,Estonia,1361,1195,2,0,5,-5,1366,1190,114,161,0,-3,114,158,20,100,266
85,Mar 9 1994,Friendly in England,England,Denmark,1876,1930,1,0,9,-9,1885,1921,12,9,0,-1,12,8,20,100,46
86,Mar 9 1994,Friendly in Hungary,Hungary,Switzerland,1646,1865,1,2,-7,7,1639,1872,48,14,-2,0,46,14,20,100,-119
87,Mar 9 1994,Friendly in Nigeria,Nigeria,Ghana,1698,1623,0,0,-5,5,1693,1628,35,46,-2,2,33,48,20,100,175
88,Mar 9 1994,Friendly in Wales,Wales,Norway,1776,1833,1,3,-17,17,1759,1850,27,16,-1,2,26,18,20,100,43
89,Mar 10 1994,Caribbean Cup qualifier in the Dominican Republic,Dominican Republic,Haiti,1020,1311,0,1,-10,10,1010,1321,191,122,-2,1,189,123,40,100,-191
90,Mar 12 1994,Friendly in Congo,Congo,Zaire,1393,1503,2,1,10,-10,1403,1493,101,86,2,-4,103,82,20,100,-10
91,Mar 12 1994,Friendly in the United States,United States,South Korea,1617,1658,1,1,-2,2,1615,1660,56,39,-1,0,55,39,20,100,59
92,Mar 12 1994,Friendly in Zambia,Zambia,Zimbabwe,1670,1557,2,1,5,-5,1675,1552,37,68,0,-1,37,67,20,100,213
93,Mar 15 1994,Friendly in Gabon,Gabon,Zaire,1435,1493,2,1,9,-9,1444,1484,91,84,2,-1,93,83,20,100,42
94,Mar 15 1994,Friendly in Israel,Israel,Ukraine,1574,1609,1,0,8,-8,1582,1601,62,60,1,-1,63,59,20,100,65
95,Mar 16 1994,Friendly in Egypt,Egypt,Cameroon,1680,1648,0,0,-4,4,1676,1652,36,40,-1,1,35,41,20,100,132
96,Mar 17 1994,Friendly in Tunisia,Tunisia,Niger,1613,1355,4,2,3,-3,1616,1352,52,119,2,-2,54,117,20,100,358
97,Mar 19 1994,Friendly in Angola,Angola,Gabon,1426,1444,2,1,8,-8,1434,1436,96,97,0,-2,96,95,20,100,82
98,Mar 22 1994,Friendly in France,France,Chile,1901,1743,3,1,6,-6,1907,1737,9,29,0,-1,9,28,20,100,258
99,Mar 23 1994,Friendly in Austria,Austria,Hungary,1644,1639,1,1,-3,3,1641,1642,48,44,-2,1,46,45,20,100,105
100,Mar 23 1994,Friendly in Brazil,Brazil,Argentina,1950,1928,2,0,10,-10,1960,1918,4,9,0,-1,4,8,20,100,122
101,Mar 23 1994,Friendly in Germany,Germany,Italy,2013,1984,2,1,6,-6,2019,1978,1,3,0,0,1,3,20,100,129
102,Mar 23 1994,Friendly in Greece,Greece,Poland,1738,1699,0,0,-4,4,1734,1703,29,30,-1,0,28,30,20,100,139
103,Mar 23 1994,Friendly in Ireland,Ireland,Russia,1839,1857,0,0,-2,2,1837,1859,18,15,1,0,19,15,20,100,82
104,Mar 23 1994,Friendly in Luxembourg,Luxembourg,Morocco,1167,1676,1,2,-2,2,1165,1678,162,35,0,0,162,35,20,100,-409
105,Mar 23 1994,Friendly in Macedonia,Macedonia,Slovenia,1622,1587,2,0,9,-9,1631,1578,43,67,4,-3,47,64,20,100,135
106,Mar 23 1994,Friendly in Northern Ireland,Northern Ireland,Romania,1670,1844,2,0,18,-18,1688,1826,30,23,4,-2,34,21,20,100,-74
107,Mar 23 1994,Friendly in Scotland,Scotland,Netherlands,1766,1988,0,1,-7,7,1759,1995,25,2,0,0,25,2,20,100,-122
108,Mar 23 1994,Friendly in Spain,Spain,Croatia,1898,1874,0,2,-20,20,1878,1894,16,7,-3,3,13,10,20,100,124
109,Mar 26 1994,African Nations Cup in Tunisia,Nigeria,Gabon,1693,1436,3,0,16,-16,1709,1420,27,99,3,-2,30,97,50,0,257
110,Mar 26 1994,African Nations Cup in Tunisia,Tunisia,Mali,1616,1440,0,2,-62,62,1554,1502,76,63,-11,15,65,78,50,100,276
111,Mar 26 1994,Friendly in the United States,United States,Bolivia,1615,1695,2,2,-1,1,1614,1696,54,33,1,-1,55,32,20,100,20
112,Mar 27 1994,Friendly in Barbados,Barbados,St Vincent & Grenadines,1297,1259,2,0,9,-9,1306,1250,120,143,6,-2,126,141,20,100,138
113,Mar 27 1994,African Nations Cup in Tunisia,Ghana,Guinea,1628,1419,1,0,12,-12,1640,1407,47,102,1,-2,48,100,50,0,209
114,Mar 27 1994,African Nations Cup in Tunisia,Ivory Coast,Sierra Leone,1624,1513,4,0,32,-32,1656,1481,31,101,10,-13,41,88,50,0,111
115,Mar 27 1994,Friendly in Saudi Arabia,Saudi Arabia,Chile,1677,1737,0,2,-17,17,1660,1754,40,27,-2,0,38,27,20,100,40
116,Mar 28 1994,African Nations Cup in Tunisia,Egypt,Gabon,1676,1420,4,0,17,-17,1693,1403,32,107,2,-5,34,102,50,0,256
117,Mar 28 1994,African Nations Cup in Tunisia,Zaire,Mali,1484,1502,1,0,26,-26,1510,1476,69,99,7,-11,76,88,50,0,-18
118,Mar 29 1994,Friendly in Saudi Arabia,Saudi Arabia,Chile,1660,1754,2,2,0,0,1660,1754,38,27,0,0,38,27,20,100,6
119,Mar 29 1994,African Nations Cup in Tunisia,Senegal,Guinea,1440,1407,2,1,23,-23,1463,1384,88,115,3,-8,91,107,50,0,33
120,Mar 29 1994,African Nations Cup in Tunisia,Sierra Leone,Zambia,1481,1675,0,0,13,-13,1494,1662,75,37,6,0,81,37,50,0,-194
121,Mar 30 1994,African Nations Cup in Tunisia,Egypt,Nigeria,1693,1709,0,0,1,-1,1694,1708,32,30,1,0,33,30,30,0,-16
122,Mar 30 1994,Friendly in Malta,Malta,Slovakia,1385,1644,1,2,-6,6,1379,1650,110,43,-2,1,108,44,20,100,-159
123,Mar 30 1994,African Nations Cup in Tunisia,Tunisia,Zaire,1554,1510,1,1,-10,10,1544,1520,75,68,-5,4,70,72,50,100,144
124,Mar 31 1994,African Nations Cup in Tunisia,Ghana,Senegal,1640,1463,1,0,13,-13,1653,1450,34,95,7,-2,41,93,50,0,177
125,Mar 31 1994,African Nations Cup in Tunisia,Zambia,Ivory Coast,1662,1656,1,0,25,-25,1687,1631,35,55,1,-7,36,48,50,0,6
126,Apr 2 1994,African Nations Cup in Tunisia,Mali,Egypt,1476,1694,1,0,39,-39,1515,1655,62,47,13,-7,75,40,50,0,-218
127,Apr 2 1994,African Nations Cup in Tunisia,Nigeria,Zaire,1708,1520,2,0,19,-19,1727,1501,28,86,1,-7,29,79,50,0,188
128,Apr 3 1994,African Nations Cup in Tunisia,Ivory Coast,Ghana,1631,1653,2,1,27,-27,1658,1626,30,61,9,-10,39,51,50,0,-22
129,Apr 3 1994,African Nations Cup in Tunisia,Zambia,Senegal,1687,1450,1,0,10,-10,1697,1440,29,95,3,-1,32,94,50,0,237
130,Apr 6 1994,Friendly in Hungary,Hungary,Slovenia,1642,1578,0,1,-14,14,1628,1592,52,57,-3,3,49,60,20,100,164
131,Apr 6 1994,African Nations Cup in Tunisia,Ivory Coast,Nigeria,1658,1727,2,2,5,-5,1663,1722,35,29,2,0,37,29,50,0,-69
132,Apr 6 1994,African Nations Cup in Tunisia,Zambia,Mali,1697,1515,4,0,24,-24,1721,1491,30,91,1,-8,31,83,50,0,182
133,Apr 7 1994,Friendly in Colombia,Colombia,Bolivia,1937,1696,0,1,-18,18,1919,1714,9,31,-2,1,7,32,20,100,341
134,Apr 7 1994,Caribbean Cup in Trinidad and Tobago,Haiti,Cayman Islands,1321,1034,3,2,6,-6,1327,1028,123,183,0,0,123,183,40,0,287
135,Apr 7 1994,Caribbean Cup in Trinidad and Tobago,Martinique,Suriname,1475,1354,2,0,20,-20,1495,1334,73,125,8,-5,81,120,40,0,121
136,Apr 8 1994,Caribbean Cup in Trinidad and Tobago,Barbados,Guadeloupe,1306,1353,2,2,3,-3,1309,1350,126,117,0,-1,126,116,40,0,-47
137,Apr 8 1994,Caribbean Cup in Trinidad and Tobago,Trinidad and Tobago,Dominica,1486,1188,5,0,7,-7,1493,1181,83,161,1,-1,84,160,40,100,398
138,Apr 9 1994,Caribbean Cup in Trinidad and Tobago,Martinique,Haiti,1495,1327,3,0,19,-19,1514,1308,69,129,6,-3,75,126,40,0,168
139,Apr 9 1994,Caribbean Cup in Trinidad and Tobago,Suriname,Cayman Islands,1334,1028,2,0,9,-9,1343,1019,114,191,3,-4,117,187,40,0,306
140,Apr 10 1994,Caribbean Cup in Trinidad and Tobago,Barbados,Dominica,1309,1181,1,1,-7,7,1302,1188,131,158,-3,1,128,159,40,0,128
141,Apr 10 1994,African Nations Cup in Tunisia,Ivory Coast,Mali,1663,1491,3,1,20,-20,1683,1471,35,93,1,-4,36,89,50,0,172
142,Apr 10 1994,African Nations Cup in Tunisia,Nigeria,Zambia,1722,1721,2,1,25,-25,1747,1696,27,35,1,-2,28,33,50,0,1
143,Apr 10 1994,Caribbean Cup in Trinidad and Tobago,Trinidad and Tobago,Guadeloupe,1493,1350,0,0,-12,12,1481,1362,92,114,-4,1,88,115,40,100,243
144,Apr 11 1994,Caribbean Cup in Trinidad and Tobago,Cayman Islands,Martinique,1019,1514,1,1,18,-18,1037,1496,179,85,4,-5,183,80,40,0,-495
145,Apr 11 1994,Caribbean Cup in Trinidad and Tobago,Haiti,Suriname,1308,1343,1,1,2,-2,1310,1341,123,121,1,-2,124,119,30,0,-35
146,Apr 11 1994,Friendly tournament in Uzbekistan,Kazakhstan,Tajikistan,1612,1378,1,0,6,-6,1618,1372,52,111,2,-1,54,110,30,0,234
147,Apr 11 1994,Friendly tournament in Uzbekistan,Uzbekistan,Turkmenistan,1657,1506,4,0,11,-11,1668,1495,36,85,2,-4,38,81,20,0,151
148,Apr 12 1994,Caribbean Cup in Trinidad and Tobago,Guadeloupe,Dominica,1362,1188,4,0,20,-20,1382,1168,99,163,8,-2,107,161,40,0,174
149,Apr 12 1994,Caribbean Cup in Trinidad and Tobago,Trinidad and Tobago,Barbados,1481,1302,2,0,10,-10,1491,1292,80,138,4,-5,84,133,40,100,279
150,Apr 13 1994,Friendly in France,Poland,Saudi Arabia,1703,1660,1,0,9,-9,1712,1651,32,45,0,-3,32,42,20,0,43
151,Apr 13 1994,Friendly tournament in Uzbekistan,Turkmenistan,Kyrgyzstan,1495,1200,5,1,9,-9,1504,1191,71,159,5,-3,76,156,30,0,295
152,Apr 13 1994,Friendly tournament in Uzbekistan,Uzbekistan,Kazakhstan,1668,1618,1,0,9,-9,1677,1609,38,58,0,-2,38,56,20,0,50
153,Apr 14 1994,Caribbean Cup in Trinidad and Tobago,Martinique,Guadeloupe,1496,1382,4,2,20,-20,1516,1362,63,123,9,-8,72,115,40,0,114
154,Apr 14 1994,Caribbean Cup in Trinidad and Tobago,Trinidad and Tobago,Suriname,1491,1341,3,2,8,-8,1499,1333,78,123,3,-2,81,121,40,100,250
155,Apr 15 1994,Friendly tournament in Uzbekistan,Kazakhstan,Turkmenistan,1609,1504,0,0,-4,4,1605,1508,56,77,0,0,56,77,30,0,105
156,Apr 15 1994,Friendly in Oman,Oman,Bulgaria,1191,1791,1,1,9,-9,1200,1782,150,24,3,0,153,24,20,0,-600
157,Apr 15 1994,Friendly tournament in Uzbekistan,Tajikistan,Kyrgyzstan,1372,1191,1,0,8,-8,1380,1183,106,162,2,-3,108,159,30,0,181
158,Apr 16 1994,Friendly in the United States,United States,Moldova,1614,1484,1,1,-6,6,1608,1490,55,85,0,0,55,85,20,100,230
159,Apr 17 1994,Friendly in Colombia,Colombia,Nigeria,1919,1747,1,0,3,-3,1922,1744,5,28,1,0,6,28,20,100,272
160,Apr 17 1994,Caribbean Cup in Trinidad and Tobago,Guadeloupe,Suriname,1362,1333,2,0,28,-28,1390,1305,97,131,9,-5,106,126,40,0,29
161,Apr 17 1994,Friendly tournament in Uzbekistan,Kazakhstan,Kyrgyzstan,1605,1183,0,0,-13,13,1592,1196,62,151,-3,4,59,155,30,0,422
162,Apr 17 1994,Caribbean Cup in Trinidad and Tobago,Trinidad and Tobago,Martinique,1499,1516,7,2,31,-31,1530,1485,63,98,9,-13,72,85,30,0,-17
163,Apr 17 1994,Friendly tournament in Uzbekistan,Uzbekistan,Tajikistan,1677,1380,1,1,-12,12,1665,1392,38,102,0,3,38,105,30,100,397
164,Apr 18 1994,Friendly in Tunisia,Tunisia,Saudi Arabia,1544,1651,2,0,15,-15,1559,1636,60,50,5,-4,65,46,20,100,-7
165,Apr 19 1994,Friendly in Malta,Malta,Azerbaijan,1379,1552,5,0,24,-24,1403,1528,92,77,9,-5,101,72,20,100,-73
166,Apr 19 1994,Friendly tournament in Uzbekistan,Turkmenistan,Tajikistan,1508,1392,2,0,15,-15,1523,1377,69,115,4,-5,73,110,30,0,116
167,Apr 19 1994,Friendly tournament in Uzbekistan,Uzbekistan,Kyrgyzstan,1665,1196,3,0,2,-2,1667,1194,38,155,0,0,38,155,20,0,469
168,Apr 20 1994,Friendly tournament in Argentina,Argentina,Morocco,1918,1678,3,1,6,-6,1924,1672,4,39,2,-1,6,38,20,0,240
169,Apr 20 1994,Friendly in Austria,Austria,Scotland,1641,1759,1,2,-9,9,1632,1768,47,25,-1,0,46,25,20,100,-18
170,Apr 20 1994,Friendly in Denmark,Denmark,Hungary,1921,1628,3,1,3,-3,1924,1625,5,53,1,-2,6,51,20,100,393
171,Apr 20 1994,Friendly in Lithuania,Lithuania,Israel,1305,1582,1,1,5,-5,1310,1577,122,62,2,0,124,62,20,100,-177
172,Apr 20 1994,Friendly in the Netherlands,Netherlands,Ireland,1995,1837,0,1,-16,16,1979,1853,2,15,0,2,2,17,20,100,258
173,Apr 20 1994,Friendly in Norway,Norway,Portugal,1850,1833,0,0,-3,3,1847,1836,18,20,0,0,18,20,20,100,117
174,Apr 20 1994,European Championship qual in Northern Ireland,Northern Ireland,Liechtenstein,1688,1115,4,1,1,-1,1689,1114,35,169,0,0,35,169,20,0,573
175,Apr 20 1994,Friendly in Romania,Romania,Bolivia,1826,1714,3,0,8,-8,1834,1706,21,33,0,-1,21,32,20,100,212
176,Apr 20 1994,Friendly in France,Saudi Arabia,Iceland,1636,1579,2,0,13,-13,1649,1566,42,65,2,-1,44,64,20,0,57
177,Apr 20 1994,Friendly in Slovakia,Slovakia,Croatia,1650,1894,4,1,24,-24,1674,1870,31,18,6,-4,37,14,20,100,-144
178,Apr 20 1994,Friendly in Swaziland,Swaziland,Mozambique,1242,1301,0,1,-11,11,1231,1312,147,117,-1,6,146,123,20,100,41
179,Apr 20 1994,Friendly in Switzerland,Switzerland,Czechia,1872,1854,3,0,12,-12,1884,1842,10,21,2,-2,12,19,20,100,118
180,Apr 20 1994,Friendly in Turkey,Turkey,Russia,1583,1859,0,1,-5,5,1578,1864,61,15,0,0,61,15,20,100,-176
181,Apr 20 1994,Friendly in the United States,United States,Moldova,1608,1490,3,0,8,-8,1616,1482,53,90,1,-3,54,87,20,100,218
182,Apr 20 1994,Friendly in Wales,Wales,Sweden,1759,1886,0,2,-14,14,1745,1900,29,9,-2,1,27,10,20,100,-27
183,Apr 24 1994,Friendly in South Africa,South Africa,Zimbabwe,1616,1552,1,0,6,-6,1622,1546,50,71,2,-2,52,69,20,100,164
184,Apr 24 1994,Friendly in the United States,United States,Iceland,1616,1566,1,2,-14,14,1602,1580,58,58,-2,3,56,61,20,100,150
185,Apr 27 1994,Friendly in Greece,Greece,Saudi Arabia,1734,1649,5,1,10,-10,1744,1639,27,46,1,-1,28,45,20,100,185
186,Apr 27 1994,Friendly in Slovenia,Slovenia,Cyprus,1592,1366,3,0,5,-5,1597,1361,57,115,1,0,58,115,20,100,326
187,Apr 27 1994,Friendly in the United Arab Emirates,United Arab Emirates,Germany,1483,2019,0,2,-2,2,1481,2021,90,1,-2,0,88,1,20,100,-436
188,Apr 28 1994,Friendly in Kuwait,Kuwait,Bulgaria,1512,1782,2,2,5,-5,1517,1777,71,24,3,0,74,24,20,100,-170
189,Apr 30 1994,Friendly in the United States,United States,Chile,1602,1754,0,2,-13,13,1589,1767,64,26,-4,0,60,26,20,100,-52
190,May 1 1994,Friendly in South Korea,South Korea,Cameroon,1660,1652,2,2,-3,3,1657,1655,40,40,0,1,40,41,20,100,108
191,May 3 1994,Friendly tournament in the United States,Colombia,Peru,1922,1551,1,0,3,-3,1925,1548,4,66,2,1,6,67,30,0,371
192,May 3 1994,Friendly tournament in the United States,El Salvador,Honduras,1494,1552,3,1,26,-26,1520,1526,66,77,8,-5,74,72,30,0,-58
193,May 3 1994,Friendly in South Korea,South Korea,Cameroon,1657,1655,2,1,7,-7,1664,1648,40,45,0,-2,40,43,20,100,102
194,May 4 1994,Friendly in France,Bolivia,Saudi Arabia,1706,1639,1,0,8,-8,1714,1631,32,47,0,-1,32,46,20,0,67
195,May 4 1994,Friendly in Brazil,Brazil,Iceland,1960,1580,3,0,2,-2,1962,1578,4,61,0,0,4,61,20,100,480
196,May 4 1994,Friendly in Poland,Poland,Hungary,1712,1625,3,2,5,-5,1717,1620,31,53,0,-1,31,52,20,100,187
197,May 5 1994,Friendly tournament in the United States,Colombia,El Salvador,1925,1520,3,0,5,-5,1930,1515,6,82,0,-4,6,78,30,0,405
198,May 5 1994,Friendly tournament in the United States,Honduras,Peru,1526,1548,2,1,16,-16,1542,1532,64,73,4,-3,68,70,30,0,-22
199,May 5 1994,Friendly in Sweden,Sweden,Nigeria,1900,1744,3,1,6,-6,1906,1738,10,30,0,-1,10,29,20,100,256
200,May 7 1994,Friendly in the United States,United States,Estonia,1589,1190,4,0,2,-2,1591,1188,60,158,0,0,60,158,20,100,499
201,May 9 1994,Friendly tournament in Greece,Greece,Cameroon,1744,1648,0,3,-40,40,1704,1688,36,29,-4,7,32,36,30,100,196
202,May 10 1994,Friendly tournament in South Africa,South Africa,Zambia,1622,1696,2,1,14,-14,1636,1682,39,41,6,-4,45,37,30,100,26
203,May 11 1994,Friendly tournament in Greece,Bolivia,Cameroon,1714,1688,1,1,-1,1,1713,1689,31,33,0,1,31,34,20,0,26
204,May 13 1994,Friendly tournament in Greece,Greece,Bolivia,1704,1713,0,0,-4,4,1700,1717,32,29,0,1,32,30,30,100,91
205,May 14 1994,Friendly in Macedonia,Macedonia,Albania,1631,1382,5,1,4,-4,1635,1378,45,109,1,0,46,109,20,100,349
206,May 14 1994,Friendly in the Netherlands,Nigeria,Suriname,1738,1305,2,1,2,-2,1740,1303,28,128,0,0,28,128,20,0,433
207,May 15 1994,Friendly in the United States,United States,Armenia,1591,1246,1,0,1,-1,1592,1245,58,144,1,0,59,144,20,100,445
208,May 17 1994,Friendly in England,England,Greece,1885,1700,5,0,6,-6,1891,1694,11,32,0,0,11,32,20,100,285
209,May 17 1994,Friendly in Poland,Poland,Austria,1717,1632,3,4,-15,15,1702,1647,32,41,-1,3,31,44,20,100,185
210,May 18 1994,Friendly in Chile,Chile,Argentina,1767,1924,3,3,2,-2,1769,1922,24,9,1,-1,25,8,20,100,-57
211,May 18 1994,Friendly in Hungary,Hungary,Croatia,1620,1870,2,2,4,-4,1624,1866,52,14,0,0,52,14,20,100,-150
212,May 19 1994,Friendly in Iceland,Iceland,Bolivia,1578,1717,1,0,11,-11,1589,1706,61,30,0,0,61,30,20,100,-39
213,May 21 1994,Friendly in Fiji,Fiji,Tahiti,1404,1538,1,1,1,-1,1405,1537,99,69,0,0,99,69,20,100,-34
214,May 22 1994,Friendly in England,England,Norway,1891,1847,0,0,-4,4,1887,1851,11,18,0,0,11,18,20,100,144
215,May 22 1994,Friendly tournament in Japan,Japan,Australia,1647,1722,1,1,-1,1,1646,1723,46,29,-1,0,45,29,20,100,25
216,May 23 1994,Friendly in Estonia,Estonia,Wales,1188,1745,1,2,-1,1,1187,1746,158,27,0,0,158,27,20,0,-557
217,May 23 1994,Friendly in Fiji,Fiji,Tahiti,1405,1537,2,2,1,-1,1406,1536,99,69,0,0,99,69,20,100,-32
218,May 24 1994,Friendly in Ireland,Ireland,Bolivia,1853,1706,1,0,4,-4,1857,1702,15,30,1,0,16,30,20,100,247
219,May 24 1994,Friendly in Romania,Romania,Nigeria,1834,1740,2,0,7,-7,1841,1733,19,28,1,0,20,28,20,100,194
220,May 25 1994,Friendly in Chile,Chile,Peru,1769,1532,2,1,3,-3,1772,1529,25,70,0,0,25,70,20,100,337
221,May 25 1994,Friendly in Czechia,Czechia,Lithuania,1842,1310,5,3,1,-1,1843,1309,19,128,0,-2,19,126,20,0,532
222,May 25 1994,Friendly in Ecuador,Ecuador,Argentina,1631,1922,1,0,15,-15,1646,1907,42,8,3,0,45,8,20,100,-191
223,May 25 1994,Friendly in Fiji,Fiji,Tahiti,1406,1536,2,0,16,-16,1422,1520,95,77,2,-4,97,73,20,100,-30
224,May 25 1994,Friendly in Ukraine,Ukraine,Belarus,1601,1416,3,1,5,-5,1606,1411,54,99,1,-1,55,98,20,100,285
225,May 25 1994,Friendly in the United States,United States,Saudi Arabia,1592,1631,0,0,-2,2,1590,1633,61,50,-1,-1,60,49,20,100,61
226,May 26 1994,Friendly in Denmark,Denmark,Sweden,1924,1906,1,0,7,-7,1931,1899,5,10,1,0,6,10,20,100,118
227,May 26 1994,Friendly tournament in Japan,France,Australia,1907,1723,1,0,8,-8,1915,1715,8,29,0,0,8,29,30,0,184
228,May 27 1994,Friendly in Italy,Italy,Finland,1978,1554,2,0,1,-1,1979,1553,3,66,0,0,3,66,20,100,524
229,May 27 1994,Friendly in the Netherlands,Netherlands,Scotland,1979,1768,3,1,4,-4,1983,1764,2,26,0,0,2,26,20,100,311
230,May 27 1994,Friendly in Switzerland,Switzerland,Liechtenstein,1884,1114,2,0,0,0,1884,1114,12,169,0,0,12,169,20,0,770
231,May 28 1994,Friendly in the United States,United States,Greece,1590,1694,1,1,0,0,1590,1694,60,32,0,0,60,32,20,100,-4
232,May 29 1994,Friendly in Germany,Germany,Ireland,2021,1857,0,2,-25,25,1996,1882,1,10,0,3,1,13,20,100,264
233,May 29 1994,Friendly tournament in Japan,Japan,France,1646,1915,1,4,-14,14,1632,1929,53,8,-4,0,49,8,30,100,-169
234,May 29 1994,Friendly in Russia,Russia,Slovakia,1864,1674,2,1,3,-3,1867,1671,15,40,0,-1,15,39,20,100,290
235,May 31 1994,Friendly in Israel,Israel,Argentina,1577,1907,0,3,-7,7,1570,1914,63,9,0,0,63,9,20,100,-230
236,Jun 1 1994,Friendly in Canada,Canada,Morocco,1597,1672,1,1,-1,1,1596,1673,59,38,-1,0,58,38,20,100,25
237,Jun 1 1994,Friendly in Macedonia,Macedonia,Estonia,1635,1187,2,0,1,-1,1636,1186,45,158,1,0,46,158,20,100,548
238,Jun 1 1994,Friendly in the Netherlands,Netherlands,Hungary,1983,1624,7,1,3,-3,1986,1621,2,52,0,0,2,52,20,100,459
239,Jun 1 1994,Friendly in Norway,Norway,Denmark,1851,1931,2,1,9,-9,1860,1922,16,10,1,-2,17,8,20,100,20
240,Jun 1 1994,Friendly in Romania,Romania,Slovenia,1841,1597,0,0,-8,8,1833,1605,22,55,-1,1,21,56,20,100,344
241,Jun 2 1994,Friendly in Austria,Austria,Germany,1647,1996,1,5,-7,7,1640,2003,46,1,-1,0,45,1,20,100,-249
242,Jun 2 1994,Friendly in Finland,Finland,Spain,1553,1878,1,2,-4,4,1549,1882,66,12,0,1,66,13,20,100,-225
243,Jun 2 1994,Friendly in Latvia,Latvia,Malta,1372,1403,2,0,12,-12,1384,1391,104,109,4,-4,108,105,20,100,69
244,Jun 3 1994,Friendly in Bulgaria,Bulgaria,Ukraine,1777,1606,1,1,-7,7,1770,1613,26,55,-1,0,25,55,20,100,271
245,Jun 3 1994,Friendly in the United States,Colombia,Northern Ireland,1930,1689,2,0,6,-6,1936,1683,4,36,1,-1,5,35,20,0,241
246,Jun 3 1994,Friendly in Italy,Italy,Switzerland,1979,1884,1,0,5,-5,1984,1879,3,16,0,-2,3,14,20,100,195
247,Jun 4 1994,Friendly in Belgium,Belgium,Zambia,1808,1682,9,0,11,-11,1819,1671,22,39,0,-1,22,38,20,100,226
248,Jun 4 1994,Friendly in Croatia,Croatia,Argentina,1866,1914,0,0,-1,1,1865,1915,16,9,0,0,16,9,20,100,52
249,Jun 4 1994,Friendly in the United States,Saudi Arabia,Trinidad and Tobago,1633,1530,3,2,7,-7,1640,1523,42,73,3,-2,45,71,20,0,103
250,Jun 4 1994,Friendly in the United States,United States,Mexico,1590,1857,1,0,14,-14,1604,1843,54,18,3,0,57,18,20,100,-167
251,Jun 5 1994,Friendly in Canada,Canada,Brazil,1596,1962,1,1,6,-6,1602,1956,59,4,0,0,59,4,20,100,-266
252,Jun 5 1994,Friendly in the United States,Colombia,Greece,1936,1694,2,0,6,-6,1942,1688,5,36,0,-2,5,34,20,0,242
253,Jun 5 1994,Friendly in the United States,Ecuador,South Korea,1646,1664,2,1,11,-11,1657,1653,38,45,3,-2,41,43,20,0,-18
254,Jun 5 1994,Friendly in Ireland,Ireland,Czechia,1882,1843,1,3,-21,21,1861,1864,22,14,-5,2,17,16,20,100,139
255,Jun 5 1994,Friendly in Ivory Coast,Ivory Coast,Liberia,1683,1368,4,1,3,-3,1686,1365,35,115,0,-1,35,114,20,100,415
256,Jun 5 1994,Friendly in Sweden,Sweden,Norway,1899,1860,2,0,9,-9,1908,1851,10,19,0,-1,10,18,20,100,139
257,Jun 8 1994,Friendly in Australia,Australia,South Africa,1715,1636,1,0,5,-5,1720,1631,29,51,0,-2,29,49,20,100,179
258,Jun 8 1994,Friendly in Belgium,Belgium,Hungary,1819,1621,3,1,5,-5,1824,1616,22,56,0,-2,22,54,20,100,298
259,Jun 8 1994,Friendly in Bolivia,Bolivia,Peru,1702,1529,0,0,-7,7,1695,1536,32,69,-1,0,31,69,20,100,273
260,Jun 8 1994,Friendly in the United States,Brazil,Honduras,1956,1542,8,2,4,-4,1960,1538,4,68,0,0,4,68,20,0,414
261,Jun 8 1994,Friendly in Canada,Canada,Germany,1602,2003,0,2,-5,5,1597,2008,59,1,0,0,59,1,20,100,-301
262,Jun 10 1994,Friendly in Canada,Canada,Spain,1597,1882,0,2,-8,8,1589,1890,61,10,-1,1,60,11,20,100,-185
263,Jun 11 1994,Friendly in Canada,Bolivia,Switzerland,1695,1879,0,0,5,-5,1700,1874,31,13,0,0,31,13,20,0,-184
264,Jun 11 1994,Friendly in the United States,Italy,Costa Rica,1984,1619,1,0,2,-2,1986,1617,1,53,1,0,2,53,20,0,365
265,Jun 11 1994,Friendly in the United States,Mexico,Northern Ireland,1843,1683,3,0,10,-10,1853,1673,17,36,1,0,18,36,20,0,160
266,Jun 11 1994,Friendly in Nigeria,Nigeria,Georgia,1733,1603,5,1,8,-8,1741,1595,28,58,0,0,28,58,20,100,230
267,Jun 11 1994,Friendly in the United States,South Korea,Honduras,1653,1538,3,0,12,-12,1665,1526,39,72,2,-2,41,70,20,0,115
268,Jun 12 1994,Friendly in Australia,Australia,South Africa,1720,1631,1,0,5,-5,1725,1626,29,51,0,-1,29,50,20,100,189
269,Jun 12 1994,Friendly in the United States,Brazil,El Salvador,1960,1515,4,0,3,-3,1963,1512,4,78,0,0,4,78,20,0,445
270,Jun 12 1994,Friendly in Canada,Canada,Netherlands,1589,1986,0,3,-5,5,1584,1991,62,2,-1,0,61,2,20,100,-297
271,Jun 12 1994,Friendly in the United States,Romania,Sweden,1833,1908,1,1,2,-2,1835,1906,21,10,0,0,21,10,20,0,-75
272,Jun 17 1994,World Cup in the United States,Germany,Bolivia,2008,1700,1,0,9,-9,2017,1691,1,33,0,-1,1,32,60,0,308
273,Jun 17 1994,World Cup in the United States,South Korea,Spain,1665,1890,2,2,17,-17,1682,1873,31,15,5,-2,36,13,60,0,-225
274,Jun 18 1994,World Cup in the United States,Ireland,Italy,1861,1986,1,0,40,-40,1901,1946,3,5,7,-1,10,4,60,0,-125
275,Jun 18 1994,World Cup in the United States,Romania,Colombia,1835,1942,3,1,58,-58,1893,1884,1,21,10,-8,11,13,60,0,-107
276,Jun 18 1994,World Cup in the United States,United States,Switzerland,1604,1874,1,1,14,-14,1618,1860,49,24,4,-6,53,18,60,100,-170
277,Jun 19 1994,World Cup in the United States,Belgium,Morocco,1824,1673,1,0,18,-18,1842,1655,18,47,2,-5,20,42,60,0,151
278,Jun 19 1994,World Cup in the United States,Cameroon,Sweden,1689,1906,2,2,17,-17,1706,1889,27,13,3,-2,30,11,60,0,-217
279,Jun 19 1994,World Cup in the United States,Norway,Mexico,1851,1853,1,0,30,-30,1881,1823,8,25,6,-3,14,22,60,0,-2
280,Jun 20 1994,World Cup in the United States,Brazil,Russia,1963,1867,2,0,33,-33,1996,1834,3,26,0,-5,3,21,60,0,96
281,Jun 20 1994,World Cup in the United States,Netherlands,Saudi Arabia,1991,1640,2,1,7,-7,1998,1633,2,49,0,-2,2,47,60,0,351
282,Jun 21 1994,World Cup in the United States,Argentina,Greece,1915,1688,4,0,24,-24,1939,1664,2,46,3,-6,5,40,60,0,227
283,Jun 21 1994,World Cup in the United States,Germany,Spain,2017,1873,1,1,-12,12,2005,1885,1,11,0,2,1,13,40,100,244
284,Jun 21 1994,World Cup in the United States,Nigeria,Bulgaria,1741,1770,3,0,57,-57,1798,1713,18,33,5,-4,23,29,60,0,-29
285,Jun 22 1994,World Cup in the United States,Switzerland,Romania,1860,1893,4,1,57,-57,1917,1836,0,28,9,-9,9,19,60,0,-33
286,Jun 22 1994,World Cup in the United States,United States,Colombia,1618,1884,2,1,43,-43,1661,1841,29,22,12,-4,41,18,60,100,-166
287,Jun 23 1994,World Cup in the United States,Bolivia,South Korea,1691,1682,0,0,-1,1,1690,1683,33,35,0,0,33,35,40,0,9
288,Jun 23 1994,World Cup in the United States,Italy,Norway,1946,1881,1,0,24,-24,1970,1857,4,18,0,-2,4,16,60,0,65
289,Jun 24 1994,World Cup in the United States,Brazil,Cameroon,1996,1706,3,0,17,-17,2013,1689,-1,36,2,-3,1,33,60,0,290
290,Jun 24 1994,World Cup in the United States,Mexico,Ireland,1823,1901,2,1,37,-37,1860,1864,10,18,6,-4,16,14,60,0,-78
291,Jun 24 1994,World Cup in the United States,Sweden,Russia,1889,1834,3,1,38,-38,1927,1796,5,25,3,-2,8,23,60,0,55
292,Jun 25 1994,World Cup in the United States,Argentina,Nigeria,1939,1798,2,1,18,-18,1957,1780,3,26,1,-2,4,24,60,0,141
293,Jun 25 1994,World Cup in the United States,Belgium,Netherlands,1842,1998,1,0,43,-43,1885,1955,6,7,6,-2,12,5,60,0,-156
294,Jun 25 1994,World Cup in the United States,Saudi Arabia,Morocco,1633,1655,2,1,32,-32,1665,1623,32,61,8,-9,40,52,60,0,-22
295,Jun 26 1994,World Cup in the United States,Bulgaria,Greece,1713,1664,4,0,48,-48,1761,1616,25,67,2,-13,27,54,60,0,49
296,Jun 26 1994,World Cup in the United States,Colombia,Switzerland,1841,1917,2,0,55,-55,1896,1862,1,24,9,-7,10,17,60,0,-76
297,Jun 26 1994,Friendly in Latvia,Latvia,Georgia,1384,1595,1,3,-10,10,1374,1605,116,56,-4,1,112,57,20,100,-111
298,Jun 26 1994,World Cup in the United States,United States,Romania,1661,1836,0,1,-24,24,1637,1860,48,16,-3,2,45,18,60,100,-75
299,Jun 27 1994,World Cup in the United States,Germany,South Korea,2005,1683,3,2,8,-8,2013,1675,0,33,1,1,1,34,60,0,322
300,Jun 27 1994,World Cup in the United States,Spain,Bolivia,1885,1690,3,1,22,-22,1907,1668,8,44,2,-6,10,38,60,0,195
301,Jun 28 1994,World Cup in the United States,Brazil,Sweden,2013,1927,1,1,-7,7,2006,1934,3,4,-1,2,2,6,30,100,186
302,Jun 28 1994,World Cup in the United States,Ireland,Norway,1864,1857,0,0,-1,1,1863,1858,19,20,-2,0,17,20,50,0,7
303,Jun 28 1994,World Cup in the United States,Italy,Mexico,1970,1860,1,1,-9,9,1961,1869,3,10,0,4,3,14,60,0,110
304,Jun 28 1994,World Cup in the United States,Russia,Cameroon,1796,1689,6,1,42,-42,1838,1647,20,54,1,-11,21,43,60,0,107
305,Jun 29 1994,World Cup in the United States,Netherlands,Morocco,1955,1623,2,1,8,-8,1963,1615,1,59,2,-4,3,55,60,0,332
306,Jun 29 1994,World Cup in the United States,Saudi Arabia,Belgium,1665,1885,1,0,47,-47,1712,1838,21,27,9,-7,30,20,60,0,-220
307,Jun 30 1994,World Cup in the United States,Bulgaria,Argentina,1761,1957,2,0,68,-68,1829,1889,19,17,4,-6,23,11,60,0,-196
308,Jun 30 1994,World Cup in the United States,Nigeria,Greece,1780,1616,2,0,25,-25,1805,1591,24,65,0,-6,24,59,60,0,164
309,Jul 1 1994,Friendly in Botswana,Botswana,Namibia,1067,1133,0,1,-11,11,1056,1144,180,163,0,2,180,165,20,100,34
310,Jul 2 1994,World Cup in the United States,Germany,Belgium,2013,1838,3,2,16,-16,2029,1822,1,24,0,-2,1,22,60,0,175
311,Jul 2 1994,World Cup in the United States,Spain,Switzerland,1907,1862,3,0,46,-46,1953,1816,1,29,4,-6,5,23,60,0,45
312,Jul 3 1994,Oce Cup q & Melanesian Cup in the Solomon Islands,Papua New Guinea,New Caledonia,1094,1286,1,0,30,-30,1124,1256,163,146,6,-6,169,140,40,0,-192
313,Jul 3 1994,World Cup in the United States,Romania,Argentina,1860,1889,3,2,32,-32,1892,1857,5,25,6,-7,11,18,60,0,-29
314,Jul 3 1994,World Cup in the United States,Sweden,Saudi Arabia,1934,1712,3,1,20,-20,1954,1692,4,34,1,-2,5,32,60,0,222
315,Jul 4 1994,Oce Cup q & Melanesian Cup in the Solomon Islands,Fiji,New Caledonia,1422,1256,3,1,17,-17,1439,1239,93,148,2,-4,95,144,40,0,166
316,Jul 4 1994,World Cup in the United States,Netherlands,Ireland,1963,1863,2,0,32,-32,1995,1831,3,24,0,-4,3,20,60,0,100
317,Jul 4 1994,World Cup in the United States,United States,Brazil,1637,2006,0,1,-11,11,1626,2017,51,2,-3,0,48,2,60,100,-269
318,Jul 5 1994,World Cup in the United States,Bulgaria,Mexico,1829,1869,1,1,3,-3,1832,1866,19,13,1,0,20,13,50,0,-40
319,Jul 5 1994,World Cup in the United States,Italy,Nigeria,1961,1805,2,1,17,-17,1978,1788,4,26,0,-1,4,25,60,0,156
320,Jul 5 1994,Oce Cup q & Melanesian Cup in the Solomon Islands,New Caledonia,Vanuatu,1239,1008,3,2,8,-8,1247,1000,138,192,3,-1,141,191,40,0,231
321,Jul 5 1994,Oce Cup q & Melanesian Cup in the Solomon Islands,Solomon Islands,Papua New Guinea,1207,1124,2,0,16,-16,1223,1108,151,175,0,-3,151,172,40,100,183
322,Jul 6 1994,Oce Cup q & Melanesian Cup in the Solomon Islands,Fiji,Papua New Guinea,1439,1108,1,0,5,-5,1444,1103,93,176,1,-2,94,174,40,0,331
323,Jul 6 1994,Oce Cup q & Melanesian Cup in the Solomon Islands,Solomon Islands,Vanuatu,1223,1000,4,0,10,-10,1233,990,141,191,5,0,146,191,40,100,323
324,Jul 7 1994,Oce Cup q & Melanesian Cup in the Solomon Islands,Papua New Guinea,Vanuatu,1103,990,1,1,-6,6,1097,996,176,191,-1,0,175,191,40,0,113
325,Jul 7 1994,Oce Cup q & Melanesian Cup in the Solomon Islands,Solomon Islands,Fiji,1233,1444,1,0,26,-26,1259,1418,130,100,8,-3,138,97,40,100,-111
326,Jul 8 1994,Oce Cup q & Melanesian Cup in the Solomon Islands,Fiji,Vanuatu,1418,996,4,2,5,-5,1423,991,95,191,1,0,96,191,40,0,422
327,Jul 8 1994,Friendly tournament in Japan,Japan,Ghana,1632,1626,3,2,11,-11,1643,1615,42,58,2,-5,44,53,30,100,106
328,Jul 8 1994,Oce Cup q & Melanesian Cup in the Solomon Islands,Solomon Islands,New Caledonia,1259,1247,3,1,21,-21,1280,1226,130,160,4,-9,134,151,40,100,112
329,Jul 9 1994,World Cup in the United States,Brazil,Netherlands,2017,1995,3,2,28,-28,2045,1967,0,5,1,-1,1,4,60,0,22
330,Jul 9 1994,World Cup in the United States,Italy,Spain,1978,1953,2,1,28,-28,2006,1925,2,10,1,-2,3,8,60,0,25
331,Jul 10 1994,World Cup in the United States,Bulgaria,Germany,1832,2029,2,1,45,-45,1877,1984,6,4,7,-1,13,3,60,0,-197
332,Jul 10 1994,World Cup in the United States,Romania,Sweden,1892,1954,2,2,5,-5,1897,1949,9,5,1,0,10,5,60,0,-62
333,Jul 13 1994,World Cup in the United States,Brazil,Sweden,2045,1949,1,0,22,-22,2067,1927,1,9,0,-2,1,7,60,0,96
334,Jul 13 1994,World Cup in the United States,Italy,Bulgaria,2006,1877,2,1,19,-19,2025,1858,2,19,0,-3,2,16,60,0,129
335,Jul 14 1994,Friendly tournament in Japan,Japan,Ghana,1643,1615,2,1,10,-10,1653,1605,40,57,2,-2,42,55,30,100,128
336,Jul 16 1994,Friendly in Armenia,Armenia,Malta,1245,1391,1,0,11,-11,1256,1380,138,111,3,-3,141,108,20,100,-46
337,Jul 16 1994,World Cup in the United States,Sweden,Bulgaria,1927,1858,4,0,45,-45,1972,1813,1,30,3,-7,4,23,60,0,69
338,Jul 17 1994,World Cup in the United States,Brazil,Italy,2067,2025,0,0,-4,4,2063,2029,1,2,0,0,1,2,20,100,142
339,Jul 19 1994,Friendly in Georgia,Georgia,Malta,1605,1380,1,1,-7,7,1598,1387,59,106,-2,1,57,107,20,100,325
340,Jul 29 1994,Baltic Cup in Lithuania,Lithuania,Estonia,1309,1186,3,0,11,-11,1320,1175,118,162,4,-2,122,160,30,100,223
341,Jul 30 1994,Baltic Cup in Lithuania,Latvia,Estonia,1374,1175,2,0,11,-11,1385,1164,104,164,4,-2,108,162,30,0,199
342,Jul 31 1994,Baltic Cup in Lithuania,Lithuania,Latvia,1320,1385,1,0,13,-13,1333,1372,120,116,1,-4,121,112,30,100,35
343,Aug 4 1994,Friendly in Niger,Niger,Togo,1352,1306,0,0,-4,4,1348,1310,116,123,0,2,116,125,20,100,146
344,Aug 8 1994,Friendly in Ivory Coast,Ivory Coast,Mali,1686,1471,2,1,3,-3,1689,1468,33,89,0,0,33,89,20,100,315
345,Aug 12 1994,Friendly tournament in Indonesia,Myanmar,Thailand,1156,1403,2,2,9,-9,1165,1394,159,107,2,-3,161,104,30,0,-247
346,Aug 16 1994,Friendly in Iceland,Iceland,Estonia,1589,1164,4,0,2,-2,1591,1162,58,163,1,0,59,163,20,100,525
347,Aug 16 1994,Friendly in Niger,Niger,Togo,1348,1310,3,2,6,-6,1354,1304,116,129,0,-2,116,127,20,100,138
348,Aug 16 1994,Friendly in Slovakia,Slovakia,Malta,1671,1387,1,1,-8,8,1663,1395,42,101,-3,3,39,104,20,100,384
349,Aug 17 1994,Friendly in Austria,Austria,Russia,1640,1838,0,3,-13,13,1627,1851,47,18,-1,0,46,18,20,100,-98
350,Aug 17 1994,Friendly in Denmark,Denmark,Finland,1922,1549,2,1,1,-1,1923,1548,9,68,0,-1,9,67,20,100,473
351,Aug 17 1994,Friendly in France,France,Czechia,1929,1864,2,2,-4,4,1925,1868,7,13,0,1,7,14,20,100,165
352,Aug 17 1994,Friendly in Israel,Israel,Croatia,1570,1865,0,4,-9,9,1561,1874,65,12,-1,1,64,13,20,100,-195
353,Aug 17 1994,Friendly in Peru,Peru,Ecuador,1536,1657,2,0,16,-16,1552,1641,64,48,2,-4,66,44,20,100,-21
354,Aug 17 1994,Friendly in Poland,Poland,Belarus,1702,1411,1,1,-8,8,1694,1419,30,98,0,0,30,98,20,100,391
355,Aug 17 1994,Friendly in Sweden,Sweden,Lithuania,1972,1333,4,2,0,0,1972,1333,4,121,0,0,4,121,20,100,739
356,Aug 19 1994,Friendly in Congo,Congo,Zaire,1403,1501,2,0,15,-15,1418,1486,97,86,2,-3,99,83,20,100,2
357,Aug 19 1994,Friendly in Egypt,Egypt,Mali,1655,1468,2,1,3,-3,1658,1465,40,91,0,-1,40,90,20,100,287
358,Aug 21 1994,Friendly in Egypt,Egypt,Mali,1658,1465,0,1,-17,17,1641,1482,46,82,-3,4,43,86,20,100,293
359,Aug 23 1994,Friendly in Burkina Faso,Burkina Faso,Niger,1404,1354,0,0,-4,4,1400,1358,105,116,-2,0,103,116,20,100,150
360,Aug 23 1994,Friendly tournament in Egypt,Egypt,Ghana,1641,1605,2,0,14,-14,1655,1591,37,61,3,-3,40,58,30,100,136
361,Aug 23 1994,Friendly in Namibia,Namibia,Botswana,1144,1056,1,1,-5,5,1139,1061,167,180,-1,0,166,180,20,100,188
362,Aug 24 1994,Friendly in Zaire,Zaire,Congo,1486,1418,2,0,8,-8,1494,1410,81,101,1,-1,82,100,20,100,168
363,Aug 25 1994,Friendly tournament in Egypt,Ghana,Zambia,1591,1671,1,0,18,-18,1609,1653,52,44,3,-4,55,40,30,0,-80
364,Aug 25 1994,Friendly in Namibia,Namibia,Botswana,1139,1061,2,3,-15,15,1124,1076,170,178,-2,1,168,179,20,100,178
365,Aug 26 1994,Friendly in Germany,United Arab Emirates,Ukraine,1481,1613,1,1,4,-4,1485,1609,79,54,5,0,84,54,20,0,-132
366,Aug 26 1994,Friendly in Zaire,Zaire,Congo,1494,1410,1,1,-5,5,1489,1415,84,98,-1,1,83,99,20,100,184
367,Aug 27 1994,Friendly tournament in Egypt,Egypt,Zambia,1655,1653,0,4,-36,36,1619,1689,61,26,-11,7,50,33,30,100,102
368,Aug 30 1994,Friendly in Iceland,Iceland,United Arab Emirates,1591,1485,1,0,5,-5,1596,1480,57,94,1,-5,58,89,20,100,206
369,Aug 31 1994,Friendly in Macedonia,Macedonia,Turkey,1636,1578,0,2,-21,21,1615,1599,60,52,-8,5,52,57,20,100,158
370,Sep 2 1994,Friendly in Moldova,Moldova,Azerbaijan,1482,1528,2,1,8,-8,1490,1520,80,75,3,-3,83,72,20,100,54
371,Sep 2 1994,Friendly in the Solomon Islands,Solomon Islands,Fiji,1280,1423,1,0,11,-11,1291,1412,134,102,0,-3,134,99,20,100,-43
372,Sep 3 1994,African Nations Cup qualifier in Senegal,Senegal,Mauritania,1440,1075,0,0,-17,17,1423,1092,96,172,-1,4,95,176,40,100,465
373,Sep 3 1994,African Nations Cup qualifier in Tanzania,Tanzania,Uganda,1310,1484,4,0,45,-45,1355,1439,109,100,8,-7,117,93,40,100,-74
374,Sep 4 1994,African Nations Cup qualifier in Angola,Angola,Namibia,1434,1124,2,0,5,-5,1439,1119,92,168,1,0,93,168,40,100,410
375,Sep 4 1994,African Nations Cup qualifier in Botswana,Botswana,Guinea,1076,1384,0,1,-9,9,1067,1393,180,104,0,2,180,106,40,100,-208
376,Sep 4 1994,African Nations Cup qualifier in Burkina Faso,Burkina Faso,Morocco,1400,1615,2,1,26,-26,1426,1589,87,70,8,-9,95,61,40,100,-115
377,Sep 4 1994,African Nations Cup qualifier in Congo,Congo,Gambia,1415,1331,1,1,-10,10,1405,1341,104,119,-3,2,101,121,40,100,184
378,Sep 4 1994,European Championship qual in Estonia,Estonia,Croatia,1162,1874,0,2,-2,2,1160,1876,163,13,0,0,163,13,40,100,-612
379,Sep 4 1994,African Nations Cup qualifier in Ethiopia,Ethiopia,Algeria,1343,1627,0,0,10,-10,1353,1617,118,54,0,-5,118,49,30,0,-284
380,Sep 4 1994,African Nations Cup qualifier in Ghana,Ghana,Sierra Leone,1609,1494,4,1,16,-16,1625,1478,40,94,7,-6,47,88,40,100,215
381,Sep 4 1994,African Nations Cup qualifier in Guinea-Bissau,Guinea-Bissau,Tunisia,1267,1559,1,3,-15,15,1252,1574,145,63,-4,1,141,64,40,100,-192
382,Sep 4 1994,European Championship qual in Israel,Israel,Poland,1561,1694,2,1,22,-22,1583,1672,62,42,1,-6,63,36,40,100,-33
383,Sep 4 1994,African Nations Cup qualifier in Liberia,Liberia,Togo,1365,1304,1,0,11,-11,1376,1293,110,135,2,-4,112,131,40,100,161
384,Sep 4 1994,African Nations Cup qualifier in Madagascar,Madagascar,South Africa,1516,1626,0,1,-19,19,1497,1645,85,40,-5,3,80,43,40,100,-10
385,Sep 4 1994,African Nations Cup qualifier in Mali,Mali,Mozambique,1482,1312,2,1,7,-7,1489,1305,80,127,3,-1,83,126,40,100,270
386,Sep 4 1994,African Nations Cup qualifier in Sudan,Sudan,Egypt,1334,1619,0,0,10,-10,1344,1609,117,57,2,-4,119,53,30,0,-285
387,Sep 4 1994,African Nations Cup qualifier in Zaire,Zaire,Malawi,1489,1411,1,1,-9,9,1480,1420,88,96,-2,2,86,98,40,100,178
388,Sep 4 1994,African Nations Cup qualifier in Zimbabwe,Zimbabwe,Lesotho,1546,1184,5,0,5,-5,1551,1179,66,158,1,0,67,158,40,100,462
389,Sep 6 1994,European Championship qual in Czechia,Czechia,Malta,1868,1395,6,1,3,-3,1871,1392,14,108,0,-2,14,106,40,100,573
390,Sep 6 1994,Friendly in Liberia,Liberia,Togo,1376,1293,1,1,-5,5,1371,1298,114,131,-1,0,113,131,20,100,183
391,Sep 6 1994,Friendly in Switzerland,Switzerland,United Arab Emirates,1816,1480,1,0,2,-2,1818,1478,22,88,0,-1,22,87,20,100,436
392,Sep 7 1994,European Championship qual in Belgium,Belgium,Armenia,1822,1256,2,0,1,-1,1823,1255,21,140,0,0,21,140,20,0,566
393,Sep 7 1994,European Championship qual in Cyprus,Cyprus,Spain,1361,1925,1,2,-3,3,1358,1928,117,7,-1,0,116,7,40,100,-464
394,Sep 7 1994,Friendly in England,England,United States,1887,1626,2,0,3,-3,1890,1623,12,50,0,-2,12,48,20,100,361
395,Sep 7 1994,European Championship qual in the Faroe Islands,Faroe Islands,Greece,1199,1591,1,5,-12,12,1187,1603,160,52,-3,4,157,56,40,100,-292
396,Sep 7 1994,European Championship qual in Finland,Finland,Scotland,1548,1764,0,2,-20,20,1528,1784,68,25,0,1,68,26,40,100,-116
397,Sep 7 1994,European Championship qual in Georgia,Georgia,Moldova,1598,1490,0,1,-31,31,1567,1521,69,62,-6,10,63,72,40,100,208
398,Sep 7 1994,European Championship qual in Hungary,Hungary,Turkey,1616,1599,2,2,-6,6,1610,1605,55,54,-2,1,53,55,40,100,117
399,Sep 7 1994,European Championship qual in Iceland,Iceland,Sweden,1596,1972,0,1,-7,7,1589,1979,58,4,0,0,58,4,40,100,-276
400,Sep 7 1994,European Championship qual in Latvia,Latvia,Ireland,1372,1831,0,3,-8,8,1364,1839,118,20,-3,0,115,20,40,100,-359
401,Sep 7 1994,European Championship qual in Liechtenstein,Liechtenstein,Austria,1114,1627,0,4,-6,6,1108,1633,173,45,-2,0,171,45,40,100,-413
402,Sep 7 1994,European Championship qual in Luxembourg,Luxembourg,Netherlands,1165,1967,0,4,-1,1,1164,1968,163,5,-1,0,162,5,20,100,-702
403,Sep 7 1994,European Championship qual in Macedonia,Macedonia,Denmark,1615,1923,1,1,11,-11,1626,1912,40,9,6,0,46,9,30,0,-308
404,Sep 7 1994,European Championship qual in Norway,Norway,Belarus,1858,1419,1,0,2,-2,1860,1417,16,99,0,0,16,99,30,0,439
405,Sep 7 1994,European Championship qual in Northern Ireland,Northern Ireland,Portugal,1673,1836,1,2,-16,16,1657,1852,43,17,-4,1,39,18,40,100,-63
406,Sep 7 1994,European Championship qual in Romania,Romania,Azerbaijan,1897,1520,3,0,4,-4,1901,1516,10,78,0,-3,10,75,20,0,377
407,Sep 7 1994,Friendly in Russia,Russia,Germany,1851,1984,0,1,-9,9,1842,1993,20,3,-1,0,19,3,20,100,-33
408,Sep 7 1994,European Championship qual in Slovakia,Slovakia,France,1663,1925,0,0,9,-9,1672,1916,31,9,4,-1,35,8,40,100,-162
409,Sep 7 1994,European Championship qual in Slovenia,Slovenia,Italy,1605,2029,1,1,15,-15,1620,2014,43,2,6,0,49,2,40,100,-324
410,Sep 7 1994,European Championship qual in Ukraine,Ukraine,Lithuania,1609,1333,0,2,-54,54,1555,1387,77,95,-12,14,65,109,40,100,376
411,Sep 7 1994,European Championship qual in Wales,Wales,Albania,1746,1378,2,0,4,-4,1750,1374,28,115,0,-3,28,112,40,100,468
412,Sep 10 1994,Friendly tournament in Qatar,Bangladesh,Yemen,1026,1247,1,0,23,-23,1049,1224,178,161,3,-9,181,152,30,0,-221
413,Sep 10 1994,Friendly tournament in Qatar,Qatar,Oman,1482,1200,0,2,-41,41,1441,1241,99,135,-7,9,92,144,30,100,382
414,Sep 11 1994,Friendly in South Korea,South Korea,Ukraine,1675,1555,1,0,4,-4,1679,1551,34,67,0,-1,34,66,20,100,220
415,Sep 12 1994,Friendly tournament in Qatar,India,Bangladesh,1135,1049,4,2,17,-17,1152,1032,162,187,2,-3,164,184,30,0,86
416,Sep 12 1994,Friendly tournament in Qatar,Qatar,Sudan,1441,1344,2,0,11,-11,1452,1333,86,126,3,-3,89,123,20,0,97
417,Sep 13 1994,Friendly in South Korea,South Korea,Ukraine,1679,1551,2,0,6,-6,1685,1545,34,68,0,-1,34,67,20,100,228
418,Sep 14 1994,Friendly tournament in Qatar,Oman,Sudan,1241,1333,1,1,4,-4,1245,1329,144,123,0,0,144,123,30,0,-92
419,Sep 14 1994,Friendly tournament in Qatar,Yemen,India,1224,1152,1,0,12,-12,1236,1140,140,168,6,-2,146,166,30,0,72
420,Sep 16 1994,Friendly tournament in Qatar,Oman,India,1245,1140,4,1,19,-19,1264,1121,130,168,7,-1,137,167,30,0,105
421,Sep 16 1994,Friendly tournament in Qatar,Qatar,Yemen,1452,1236,2,0,6,-6,1458,1230,89,148,0,-1,89,147,30,100,316
422,Sep 18 1994,Friendly tournament in Qatar,Qatar,Oman,1458,1264,1,2,-25,25,1433,1289,99,133,-5,2,94,135,30,100,294
423,Sep 18 1994,Friendly tournament in Qatar,Yemen,India,1230,1121,2,0,16,-16,1246,1105,143,175,2,-4,145,171,30,0,109
424,Sep 19 1994,Friendly in South Korea,South Korea,United Arab Emirates,1685,1478,0,0,-7,7,1678,1485,34,82,0,2,34,84,20,100,307
425,Sep 21 1994,Friendly in Chile,Chile,Bolivia,1772,1668,1,2,-15,15,1757,1683,27,31,0,3,27,34,20,100,204
426,Sep 21 1994,Friendly in Ecuador,Ecuador,Peru,1641,1552,0,0,-5,5,1636,1557,44,65,0,0,44,65,20,100,189
427,Sep 22 1994,Friendly in Malaysia,Malaysia,Kuwait,1257,1517,0,2,-9,9,1248,1526,146,64,-3,5,143,69,20,100,-160
428,Sep 24 1994,Friendly in Malaysia,Australia,Kuwait,1725,1526,0,0,-5,5,1720,1531,29,67,0,1,29,68,20,0,199
429,Sep 25 1994,Friendly in Zambia,Zambia,Ghana,1689,1625,3,0,10,-10,1699,1615,28,57,2,-5,30,52,20,100,164
430,Sep 29 1994,Friendly in Japan,Japan,Australia,1653,1720,0,0,-1,1,1652,1721,40,29,0,0,40,29,20,100,33
431,Oct 1 1994,Asian Games in Japan,Bahrain,Yemen,1402,1246,2,0,17,-17,1419,1229,95,151,4,-3,99,148,40,0,156
432,Oct 1 1994,Asian Games in Japan,China,Turkmenistan,1516,1523,2,2,0,0,1516,1523,75,69,0,1,75,70,20,0,-7
433,Oct 1 1994,Asian Games in Japan,Kuwait,Oman,1531,1289,2,2,-12,12,1519,1301,80,123,-6,6,74,129,40,0,242
434,Oct 1 1994,Asian Games in Japan,Malaysia,Hong Kong,1248,1194,4,3,17,-17,1265,1177,133,164,5,-5,138,159,40,0,54
435,Oct 1 1994,Asian Games in Japan,South Korea,Nepal,1678,890,11,0,1,-1,1679,889,35,199,0,0,35,199,20,0,788
436,Oct 1 1994,Asian Games in Japan,Uzbekistan,Saudi Arabia,1667,1692,4,1,38,-38,1705,1654,22,46,8,-7,30,39,40,0,-25
437,Oct 3 1994,Asian Games in Japan,Bahrain,Iran,1419,1567,0,0,8,-8,1427,1559,89,65,5,-1,94,64,40,0,-148
438,Oct 3 1994,Asian Games in Japan,China,Yemen,1516,1229,4,0,12,-12,1528,1217,61,156,7,-4,68,152,40,0,287
439,Oct 3 1994,Asian Games in Japan,Hong Kong,Thailand,1177,1394,2,1,31,-31,1208,1363,147,126,6,-11,153,115,40,0,-217
440,Oct 3 1994,Asian Games in Japan,Japan,United Arab Emirates,1652,1485,1,1,-13,13,1639,1498,46,78,-3,3,43,81,40,100,267
441,Oct 3 1994,Asian Games in Japan,Kuwait,Nepal,1519,889,8,0,2,-2,1521,887,72,199,1,0,73,199,30,0,630
442,Oct 3 1994,Asian Games in Japan,Myanmar,Qatar,1165,1433,2,2,13,-13,1178,1420,157,102,2,-4,159,98,40,0,-268
443,Oct 3 1994,Asian Games in Japan,Uzbekistan,Malaysia,1705,1265,5,0,6,-6,1711,1259,30,140,0,-1,30,139,40,0,440
444,Oct 5 1994,Asian Games in Japan,China,Bahrain,1528,1427,3,2,14,-14,1542,1413,68,106,0,-6,68,100,40,0,101
445,Oct 5 1994,Asian Games in Japan,Iran,Turkmenistan,1559,1523,1,1,-2,2,1557,1525,64,71,0,0,64,71,30,0,36
446,Oct 5 1994,Asian Games in Japan,Japan,Qatar,1639,1420,1,1,-15,15,1624,1435,49,90,-3,4,46,94,40,100,319
447,Oct 5 1994,Asian Games in Japan,Saudi Arabia,Thailand,1654,1363,4,2,9,-9,1663,1354,37,121,1,-3,38,118,40,0,291
448,Oct 5 1994,Asian Games in Japan,South Korea,Oman,1679,1301,2,1,4,-4,1683,1297,33,135,1,-3,34,132,40,0,378
449,Oct 5 1994,Asian Games in Japan,United Arab Emirates,Myanmar,1498,1178,2,0,8,-8,1506,1170,77,161,2,-1,79,160,40,0,320
450,Oct 5 1994,Asian Games in Japan,Uzbekistan,Hong Kong,1711,1208,1,0,2,-2,1713,1206,30,153,0,0,30,153,30,0,503
451,Oct 7 1994,Asian Games in Japan,China,Iran,1542,1557,1,0,21,-21,1563,1536,60,74,4,-5,64,69,40,0,-15
452,Oct 7 1994,Asian Games in Japan,Kuwait,South Korea,1521,1683,1,0,29,-29,1550,1654,61,44,6,-5,67,39,40,0,-162
453,Oct 7 1994,Asian Games in Japan,Saudi Arabia,Malaysia,1663,1259,2,1,4,-4,1667,1255,36,141,1,-1,37,140,40,0,404
454,Oct 7 1994,Asian Games in Japan,Turkmenistan,Yemen,1525,1217,4,0,11,-11,1536,1206,67,152,2,0,69,152,40,0,308
455,Oct 7 1994,Asian Games in Japan,Uzbekistan,Thailand,1713,1354,5,4,4,-4,1717,1350,30,120,0,-1,30,119,40,0,359
456,Oct 8 1994,European Championship qual in Armenia,Armenia,Cyprus,1255,1358,0,0,0,0,1255,1358,140,115,0,0,140,115,20,100,-3
457,Oct 8 1994,European Championship qual in Estonia,Estonia,Italy,1160,2014,0,2,-1,1,1159,2015,163,2,0,0,163,2,30,100,-754
458,Oct 8 1994,European Championship qual in France,France,Romania,1916,1901,0,0,-6,6,1910,1907,10,10,-1,0,9,10,40,100,115
459,Oct 9 1994,Asian Games in Japan,Bahrain,Turkmenistan,1413,1536,2,2,7,-7,1420,1529,96,71,2,-1,98,70,40,0,-123
460,Oct 9 1994,European Championship qual in Croatia,Croatia,Lithuania,1876,1387,2,0,2,-2,1878,1385,13,108,0,0,13,108,20,0,489
461,Oct 9 1994,Asian Games in Japan,Iran,Yemen,1536,1206,4,0,10,-10,1546,1196,67,156,1,-2,68,154,40,0,330
462,Oct 9 1994,Asian Games in Japan,Japan,Myanmar,1624,1170,5,0,3,-3,1627,1167,44,162,1,-1,45,161,20,0,454
463,Oct 9 1994,European Championship qual in Latvia,Latvia,Portugal,1364,1852,1,3,-6,6,1358,1858,114,16,0,1,114,17,40,100,-388
464,Oct 9 1994,Asian Games in Japan,Malaysia,Thailand,1255,1350,1,1,5,-5,1260,1345,138,119,1,0,139,119,40,0,-95
465,Oct 9 1994,Asian Games in Japan,Oman,Nepal,1297,887,1,0,3,-3,1300,884,126,199,3,0,129,199,30,0,410
466,Oct 9 1994,Asian Games in Japan,Qatar,United Arab Emirates,1435,1506,2,2,4,-4,1439,1502,90,79,2,0,92,79,40,0,-71
467,Oct 9 1994,Asian Games in Japan,Saudi Arabia,Hong Kong,1667,1206,2,1,3,-3,1670,1203,37,152,0,0,37,152,40,0,461
468,Oct 9 1994,Friendly in Senegal,Senegal,Niger,1423,1358,3,1,8,-8,1431,1350,94,121,1,-3,95,118,20,100,165
469,Oct 9 1994,Friendly in Zambia,Zambia,Malawi,1699,1420,2,1,2,-2,1701,1418,31,100,0,-1,31,99,20,100,379
470,Oct 11 1994,Asian Games in Japan,China,Saudi Arabia,1563,1670,2,0,39,-39,1602,1631,50,51,7,-7,57,44,40,0,-107
471,Oct 11 1994,Asian Games in Japan,Japan,South Korea,1627,1654,2,3,-24,24,1603,1678,65,31,-10,4,55,35,40,100,73
472,Oct 11 1994,Asian Games in Japan,Kuwait,United Arab Emirates,1550,1502,2,1,17,-17,1567,1485,61,89,3,-5,64,84,40,0,48
473,Oct 11 1994,Asian Games in Japan,Uzbekistan,Turkmenistan,1717,1529,3,0,18,-18,1735,1511,28,86,1,-8,29,78,40,0,188
474,Oct 12 1994,European Championship qual in Austria,Austria,Northern Ireland,1633,1657,1,2,-24,24,1609,1681,65,32,-11,3,54,35,40,100,76
475,Oct 12 1994,European Championship qual in Belarus,Belarus,Luxembourg,1417,1164,2,0,7,-7,1424,1157,94,164,3,-1,97,163,40,100,353
476,Oct 12 1994,European Championship qual in Bulgaria,Bulgaria,Georgia,1813,1567,2,0,7,-7,1820,1560,21,66,1,-1,22,65,40,100,346
477,Oct 12 1994,European Championship qual in Denmark,Denmark,Belgium,1912,1823,3,1,15,-15,1927,1808,8,25,0,-2,8,23,40,100,189
478,Oct 12 1994,Friendly in England,England,Romania,1890,1907,1,1,-2,2,1888,1909,12,10,0,0,12,10,20,100,83
479,Oct 12 1994,European Championship qual in Greece,Greece,Finland,1603,1528,4,0,20,-20,1623,1508,35,86,10,-8,45,78,40,100,175
480,Oct 12 1994,Friendly in Hungary,Hungary,Germany,1610,1993,0,0,7,-7,1617,1986,46,3,3,0,49,3,20,100,-283
481,Oct 12 1994,European Championship qual in Ireland,Ireland,Liechtenstein,1839,1108,4,0,1,-1,1840,1107,22,170,-1,0,21,170,20,0,731
482,Oct 12 1994,European Championship qual in Israel,Israel,Slovakia,1583,1672,2,2,-1,1,1582,1673,60,40,1,-2,61,38,40,100,11
483,Oct 12 1994,European Championship qual in Macedonia,Macedonia,Spain,1626,1928,0,2,-14,14,1612,1942,61,5,-8,1,53,6,40,100,-202
484,Oct 12 1994,European Championship qual in Malta,Malta,Czechia,1392,1871,0,0,16,-16,1408,1855,99,22,3,-4,102,18,40,100,-379
485,Oct 12 1994,European Championship qual in Moldova,Moldova,Wales,1521,1750,3,2,27,-27,1548,1723,63,30,5,-1,68,29,40,100,-129
486,Oct 12 1994,European Championship qual in Norway,Norway,Netherlands,1860,1968,1,1,0,0,1860,1968,14,3,1,1,15,4,20,100,-8
487,Oct 12 1994,European Championship qual in Poland,Poland,Azerbaijan,1672,1516,1,0,7,-7,1679,1509,36,79,0,-2,36,77,40,100,256
488,Oct 12 1994,European Championship qual in Russia,Russia,San Marino,1842,1012,4,0,0,0,1842,1012,21,188,-1,0,20,188,20,0,830
489,Oct 12 1994,European Championship qual in Scotland,Scotland,Faroe Islands,1784,1187,5,1,1,-1,1785,1186,26,157,0,0,26,157,20,0,597
490,Oct 12 1994,European Championship qual in Switzerland,Switzerland,Sweden,1818,1979,4,2,35,-35,1853,1944,16,6,3,-1,19,5,40,100,-61
491,Oct 12 1994,European Championship qual in Turkey,Turkey,Iceland,1605,1589,5,0,27,-27,1632,1562,32,69,11,-5,43,64,40,100,116
492,Oct 12 1994,European Championship qual in Ukraine,Ukraine,Slovenia,1545,1620,0,0,-1,1,1544,1621,71,47,-1,0,70,47,20,100,25
493,Oct 13 1994,Asian Games in Japan,China,Kuwait,1602,1567,2,0,27,-27,1629,1540,33,77,12,-7,45,70,40,0,35
494,Oct 13 1994,Asian Games in Japan,Uzbekistan,South Korea,1735,1678,1,0,17,-17,1752,1661,28,39,0,-1,28,38,40,0,57
495,Oct 14 1994,African Nations Cup qualifier in Algeria,Algeria,Sudan,1617,1329,1,1,-16,16,1601,1345,64,115,-7,4,57,119,40,100,388
496,Oct 14 1994,African Nations Cup qualifier in Egypt,Egypt,Tanzania,1609,1355,5,1,9,-9,1618,1346,45,120,5,-2,50,118,40,100,354
497,Oct 14 1994,African Nations Cup qualifier in Mauritania,Mauritania,Guinea-Bissau,1092,1252,1,1,3,-3,1095,1249,176,144,0,-1,176,143,30,100,-60
498,Oct 15 1994,Asian Games in Japan,Kuwait,South Korea,1540,1661,2,1,27,-27,1567,1634,56,46,7,-4,63,42,40,0,-121
499,Oct 15 1994,African Nations Cup qualifier in Malawi,Malawi,Zimbabwe,1418,1551,3,1,33,-33,1451,1518,80,80,10,-7,90,73,40,100,-33
500,Oct 15 1994,African Nations Cup qualifier in Namibia,Namibia,Mali,1119,1489,2,1,33,-33,1152,1456,161,95,3,-6,164,89,40,100,-270
501,Oct 15 1994,African Nations Cup qualifier in South Africa,South Africa,Mauritius,1645,1228,1,0,2,-2,1647,1226,37,151,2,-1,39,150,20,0,417
502,Oct 15 1994,African Nations Cup qualifier in Uganda,Uganda,Ethiopia,1439,1353,4,1,18,-18,1457,1335,84,130,4,-7,88,123,40,100,186
503,Oct 16 1994,African Nations Cup qualifier in Cameroon,Cameroon,Zaire,1647,1480,1,0,7,-7,1654,1473,37,87,1,-1,38,86,40,100,267
504,Oct 16 1994,African Nations Cup qualifier in Guinea,Guinea,Angola,1393,1439,3,1,25,-25,1418,1414,93,106,6,-6,99,100,30,0,-46
505,Oct 16 1994,African Nations Cup qualifier in Mozambique,Mozambique,Botswana,1305,1067,3,1,8,-8,1313,1059,126,180,0,0,126,180,40,100,338
506,Oct 16 1994,African Nations Cup qualifier in Niger,Niger,Ghana,1350,1615,1,5,-21,21,1329,1636,132,29,-8,12,124,41,40,100,-165
507,Oct 16 1994,African Nations Cup qualifier in Sierra Leone,Sierra Leone,Congo,1478,1405,3,2,11,-11,1489,1394,80,107,3,-2,83,105,40,100,173
508,Oct 16 1994,African Nations Cup qualifier in Togo,Togo,Senegal,1298,1431,2,0,33,-33,1331,1398,114,112,9,-8,123,104,40,100,-33
509,Oct 16 1994,Asian Games in Japan,Uzbekistan,China,1752,1629,4,2,20,-20,1772,1609,26,63,1,-9,27,54,40,0,123
510,Oct 19 1994,Friendly tournament in Peru,Peru,Uruguay,1557,1795,0,1,-9,9,1548,1804,66,24,0,0,66,24,30,100,-138
511,Oct 19 1994,Friendly in Saudi Arabia,Saudi Arabia,United States,1631,1623,2,1,7,-7,1638,1616,37,58,4,-6,41,52,20,100,108
512,Oct 23 1994,Friendly in Oman,Oman,Senegal,1300,1398,0,1,-10,10,1290,1408,140,100,-5,2,135,102,20,100,2
513,Oct 25 1994,Friendly in Oman,Oman,Senegal,1290,1408,2,1,11,-11,1301,1397,125,106,5,-2,130,104,20,100,-18
514,Oct 26 1994,Friendly in Estonia,Estonia,Finland,1159,1508,0,7,-9,9,1150,1517,166,70,-2,4,164,74,20,100,-249
515,Oct 26 1994,Friendly in Saudi Arabia,Saudi Arabia,Trinidad and Tobago,1638,1523,1,0,4,-4,1642,1519,41,73,0,-1,41,72,20,100,215
516,Oct 28 1994,Friendly in the United Arab Emirates,United Arab Emirates,Senegal,1485,1397,3,2,5,-5,1490,1392,82,106,1,-1,83,105,20,100,188
517,Oct 29 1994,Friendly in the United Arab Emirates,Iceland,Kuwait,1562,1567,1,0,10,-10,1572,1557,62,67,1,-2,63,65,20,0,-5
518,Oct 30 1994,African Nations Cup qualifier in Mali,Mali,Guinea,1456,1418,2,0,19,-19,1475,1399,83,107,3,-4,86,103,40,100,138
519,Nov 3 1994,Gulf Cup in the United Arab Emirates,United Arab Emirates,Qatar,1490,1439,2,0,18,-18,1508,1421,75,100,4,-3,79,97,40,100,151
520,Nov 4 1994,Gulf Cup in the United Arab Emirates,Bahrain,Kuwait,1420,1557,2,1,28,-28,1448,1529,88,73,5,-4,93,69,40,0,-137
521,Nov 4 1994,Gulf Cup in the United Arab Emirates,Saudi Arabia,Oman,1642,1301,2,1,5,-5,1647,1296,39,134,1,-2,40,132,40,0,341
522,Nov 6 1994,Gulf Cup in the United Arab Emirates,Bahrain,Oman,1448,1296,1,1,-8,8,1440,1304,95,124,-1,4,94,128,40,0,152
523,Nov 6 1994,Friendly in Latvia,Latvia,Estonia,1358,1150,0,0,-7,7,1351,1157,116,160,-1,2,115,162,20,100,308
524,Nov 6 1994,Gulf Cup in the United Arab Emirates,United Arab Emirates,Saudi Arabia,1508,1647,1,1,2,-2,1510,1645,77,42,1,-1,78,41,30,100,-39
525,Nov 7 1994,Gulf Cup in the United Arab Emirates,Kuwait,Qatar,1529,1421,1,0,14,-14,1543,1407,69,104,0,-3,69,101,40,0,108
526,Nov 7 1994,Friendly in Morocco,Morocco,Cameroon,1589,1654,1,1,-1,1,1588,1655,59,38,0,0,59,38,20,100,35
527,Nov 8 1994,Friendly in Tunisia,Tunisia,Ivory Coast,1574,1689,2,0,16,-16,1590,1673,56,39,3,-3,59,36,20,100,-15
528,Nov 9 1994,Gulf Cup in the United Arab Emirates,Qatar,Oman,1407,1304,4,2,21,-21,1428,1283,89,142,6,-7,95,135,40,0,103
529,Nov 9 1994,Gulf Cup in the United Arab Emirates,United Arab Emirates,Kuwait,1510,1543,2,0,24,-24,1534,1519,60,75,9,-3,69,72,40,100,67
530,Nov 10 1994,Gulf Cup in the United Arab Emirates,Saudi Arabia,Bahrain,1645,1440,3,1,14,-14,1659,1426,35,96,3,-1,38,95,40,0,205
531,Nov 11 1994,African Nations Cup qualifier in Egypt,Egypt,Ethiopia,1618,1335,5,0,8,-8,1626,1327,43,126,3,-2,46,124,40,100,383
532,Nov 11 1994,African Nations Cup qualifier in Mauritania,Mauritania,Liberia,1095,1371,1,1,9,-9,1104,1362,168,114,4,-1,172,113,40,100,-176
533,Nov 12 1994,African Nations Cup qualifier in The Gambia,Gambia,Ghana,1341,1636,1,2,-10,10,1331,1646,120,42,0,0,120,42,40,100,-195
534,Nov 12 1994,European Championship qual in Romania,Romania,Slovakia,1909,1673,3,2,5,-5,1914,1668,8,38,1,-1,9,37,40,100,336
535,Nov 12 1994,Gulf Cup in the United Arab Emirates,Saudi Arabia,Qatar,1659,1428,2,1,8,-8,1667,1420,38,102,0,-4,38,98,40,0,231
536,Nov 12 1994,African Nations Cup qualifier in Tanzania,Tanzania,Sudan,1346,1345,2,0,22,-22,1368,1323,108,131,4,-7,112,124,30,0,1
537,Nov 12 1994,Gulf Cup in the United Arab Emirates,United Arab Emirates,Bahrain,1534,1426,0,0,-11,11,1523,1437,71,93,-1,1,70,94,40,100,208
538,Nov 12 1994,African Nations Cup qualifier in Uganda,Uganda,Algeria,1457,1601,1,1,3,-3,1460,1598,89,57,0,0,89,57,40,100,-44
539,Nov 13 1994,African Nations Cup qualifier in Gabon,Gabon,Mauritius,1403,1226,3,0,12,-12,1415,1214,100,154,1,-2,101,152,40,100,277
540,Nov 13 1994,African Nations Cup qualifier in Guinea-Bissau,Guinea-Bissau,Senegal,1249,1392,1,4,-31,31,1218,1423,159,89,-8,8,151,97,40,100,-43
541,Nov 13 1994,Gulf Cup in the United Arab Emirates,Kuwait,Oman,1519,1283,0,0,-12,12,1507,1295,86,129,-7,3,79,132,40,0,236
542,Nov 13 1994,African Nations Cup qualifier in Lesotho,Lesotho,Cameroon,1179,1655,2,0,54,-54,1233,1601,132,75,13,-18,145,57,40,100,-376
543,Nov 13 1994,African Nations Cup qualifier in Mali,Mali,Angola,1475,1414,0,0,-9,9,1466,1423,86,95,0,2,86,97,40,100,161
544,Nov 13 1994,African Nations Cup qualifier in Morocco,Morocco,Ivory Coast,1588,1673,1,0,19,-19,1607,1654,48,42,6,-3,54,39,30,0,-85
545,Nov 13 1994,African Nations Cup qualifier in Mozambique,Mozambique,Guinea,1313,1399,2,1,19,-19,1332,1380,118,113,4,-5,122,108,30,0,-86
546,Nov 13 1994,African Nations Cup qualifier in Namibia,Namibia,Botswana,1152,1059,1,1,-10,10,1142,1069,168,180,-2,0,166,180,40,100,193
547,Nov 13 1994,African Nations Cup qualifier in Niger,Niger,Sierra Leone,1329,1489,4,2,35,-35,1364,1454,106,94,8,-5,114,89,40,100,-60
548,Nov 13 1994,European Championship qual in Portugal,Portugal,Austria,1858,1609,1,0,5,-5,1863,1604,14,56,1,-1,15,55,40,100,349
549,Nov 13 1994,African Nations Cup qualifier in Tunisia,Tunisia,Togo,1590,1331,1,1,-16,16,1574,1347,65,116,-3,2,62,118,40,100,359
550,Nov 13 1994,European Championship qual in Ukraine,Ukraine,Estonia,1544,1157,3,0,4,-4,1548,1153,62,164,3,-1,65,163,40,100,487
551,Nov 13 1994,African Nations Cup qualifier in Zambia,Zambia,South Africa,1701,1647,1,1,-8,8,1693,1655,33,35,-1,3,32,38,40,100,154
552,Nov 13 1994,African Nations Cup qualifier in Zimbabwe,Zimbabwe,Zaire,1518,1473,2,1,12,-12,1530,1461,64,87,5,0,69,87,40,100,145
553,Nov 15 1994,Gulf Cup in the United Arab Emirates,Bahrain,Qatar,1437,1420,1,1,-1,1,1436,1421,94,100,0,0,94,100,30,0,17
554,Nov 15 1994,Friendly in Grenada,Grenada,Trinidad and Tobago,1279,1519,1,2,-6,6,1273,1525,136,69,0,2,136,71,20,100,-140
555,Nov 15 1994,European Championship qual in Liechtenstein,Liechtenstein,Latvia,1107,1351,0,1,-12,12,1095,1363,182,113,-6,2,176,115,40,100,-144
556,Nov 16 1994,European Championship qual in Albania,Albania,Germany,1374,1986,1,2,-2,2,1372,1988,111,1,0,1,111,2,40,100,-512
557,Nov 16 1994,European Championship qual in Belarus,Belarus,Norway,1424,1860,0,4,-9,9,1415,1869,106,16,-5,0,101,16,40,100,-336
558,Nov 16 1994,European Championship qual in Belgium,Belgium,Macedonia,1808,1612,1,1,-14,14,1794,1626,25,38,-1,7,24,45,40,100,296
559,Nov 16 1994,European Championship qual in Bulgaria,Bulgaria,Moldova,1820,1548,4,1,7,-7,1827,1541,22,71,0,-3,22,68,40,100,372
560,Nov 16 1994,Friendly in Chile,Chile,Argentina,1757,1857,0,3,-18,18,1739,1875,28,11,0,3,28,14,20,100,0
561,Nov 16 1994,European Championship qual in Cyprus,Cyprus,Armenia,1358,1255,2,0,14,-14,1372,1241,105,145,6,-2,111,143,40,100,203
562,Nov 16 1994,Friendly in England,England,Nigeria,1888,1788,1,0,5,-5,1893,1783,14,25,-1,0,13,25,20,100,200
563,Nov 16 1994,European Championship qual in Finland,Finland,Faroe Islands,1517,1186,5,0,6,-6,1523,1180,72,158,1,0,73,158,40,100,431
564,Nov 16 1994,European Championship qual in Georgia,Georgia,Wales,1560,1723,5,0,47,-47,1607,1676,42,41,11,-6,53,35,40,100,-63
565,Nov 16 1994,European Championship qual in Greece,Greece,San Marino,1623,1012,2,0,1,-1,1624,1011,48,188,-1,0,47,188,20,0,611
566,Nov 16 1994,European Championship qual in Turkey,Israel,Azerbaijan,1582,1509,2,0,24,-24,1606,1485,49,88,6,-5,55,83,40,0,73
567,Nov 16 1994,European Championship qual in Italy,Italy,Croatia,2015,1878,1,2,-32,32,1983,1910,4,5,-1,4,3,9,40,100,237
568,Nov 16 1994,European Championship qual in the Netherlands,Netherlands,Czechia,1968,1855,0,0,-11,11,1957,1866,6,16,-1,1,5,17,40,100,213
569,Nov 16 1994,European Championship qual in Northern Ireland,Northern Ireland,Ireland,1681,1840,0,4,-31,31,1650,1871,46,9,-6,6,40,15,40,100,-59
570,Nov 16 1994,European Championship qual in Poland,Poland,France,1679,1910,0,0,7,-7,1686,1903,29,10,3,0,32,10,40,100,-131
571,Nov 16 1994,Gulf Cup in the United Arab Emirates,Saudi Arabia,Kuwait,1667,1507,2,0,17,-17,1684,1490,29,85,4,-3,33,82,40,0,160
572,Nov 16 1994,European Championship qual in Scotland,Scotland,Russia,1785,1842,1,1,-2,2,1783,1844,24,22,1,-1,25,21,30,100,43
573,Nov 16 1994,European Championship qual in Slovenia,Slovenia,Lithuania,1621,1385,1,2,-35,35,1586,1420,75,93,-14,7,61,100,40,100,336
574,Nov 16 1994,European Championship qual in Spain,Spain,Denmark,1942,1927,3,0,24,-24,1966,1903,2,12,2,-2,4,10,40,100,115
575,Nov 16 1994,European Championship qual in Sweden,Sweden,Hungary,1944,1617,2,0,5,-5,1949,1612,7,53,-1,-2,6,51,40,100,427
576,Nov 16 1994,European Championship qual in Switzerland,Switzerland,Iceland,1853,1572,1,0,4,-4,1857,1568,21,65,-1,-1,20,64,40,100,381
577,Nov 16 1994,Gulf Cup in the United Arab Emirates,United Arab Emirates,Oman,1523,1295,2,0,8,-8,1531,1287,66,138,3,-3,69,135,40,100,328
578,Nov 19 1994,Friendly in Trinidad and Tobago,Trinidad and Tobago,United States,1525,1616,1,0,10,-10,1535,1606,66,58,3,-4,69,54,20,100,9
579,Nov 20 1994,African Nations Cup qualifier in Gabon,Gabon,Zambia,1415,1693,2,1,29,-29,1444,1664,87,41,7,-5,94,36,40,100,-178
580,Nov 22 1994,Friendly in Jamaica,Jamaica,United States,1451,1606,0,3,-15,15,1436,1621,98,42,-4,6,94,48,20,100,-55
581,Nov 24 1994,Oce Cup q & Polynesian Cup in Western Samoa,Tahiti,Tonga,1520,663,1,0,0,0,1520,663,74,213,0,0,74,213,20,0,857
582,Nov 24 1994,Oce Cup q & Polynesian Cup in Western Samoa,Western Samoa,Eastern Samoa,601,568,3,1,19,-19,620,549,213,220,1,-1,214,219,40,100,133
583,Nov 25 1994,Oce Cup q & Polynesian Cup in Western Samoa,Tahiti,Eastern Samoa,1520,549,2,1,0,0,1520,549,74,219,0,0,74,219,20,0,971
584,Nov 25 1994,Oce Cup q & Polynesian Cup in Western Samoa,Western Samoa,Tonga,620,663,2,2,-3,3,617,666,214,213,0,0,214,213,40,100,57
585,Nov 26 1994,Simba Cup in South Africa,Ivory Coast,Cameroon,1654,1601,2,1,13,-13,1667,1588,34,62,2,-2,36,60,30,0,53
586,Nov 26 1994,CECAFA Cup in Kenya,Kenya,Somalia,1447,1201,3,1,7,-7,1454,1194,86,156,3,-1,89,155,40,100,346
587,Nov 26 1994,Simba Cup in South Africa,South Africa,Ghana,1655,1646,2,1,10,-10,1665,1636,37,41,0,0,37,41,20,0,9
588,Nov 28 1994,CECAFA Cup in Kenya,Kenya,Djibouti,1454,903,4,1,2,-2,1456,901,89,196,0,0,89,196,30,0,551
589,Nov 28 1994,Oce Cup q & Polynesian Cup in Western Samoa,Tonga,Eastern Samoa,666,549,2,1,14,-14,680,535,211,219,1,0,212,219,40,0,117
590,Nov 28 1994,Oce Cup q & Polynesian Cup in Western Samoa,Western Samoa,Tahiti,617,1520,0,7,-1,1,616,1521,216,74,-1,0,215,74,30,100,-803
591,Nov 29 1994,CECAFA Cup in Kenya,Eritrea,Seychelles,1229,936,1,0,6,-6,1235,930,142,194,3,0,145,194,40,0,293
592,Nov 29 1994,Friendly in Israel,Israel,Cyprus,1606,1372,4,3,3,-3,1609,1369,49,115,3,-2,52,113,20,100,334
593,Nov 29 1994,CECAFA Cup in Kenya,Tanzania,Somalia,1368,1194,4,0,20,-20,1388,1174,103,163,5,-4,108,159,40,0,174
594,Nov 30 1994,Simba Cup in South Africa,Ghana,Cameroon,1636,1588,1,0,13,-13,1649,1575,41,64,0,-2,41,62,30,0,48
595,Nov 30 1994,Simba Cup in South Africa,South Africa,Ivory Coast,1665,1667,0,0,-4,4,1661,1671,39,34,-1,1,38,35,30,100,98
596,Nov 30 1994,Friendly in Spain,Spain,Finland,1966,1523,2,0,1,-1,1967,1522,4,73,0,0,4,73,20,100,543
597,Dec 1 1994,CECAFA Cup in Kenya,Kenya,Tanzania,1456,1388,0,1,-29,29,1427,1417,101,96,-6,6,95,102,40,100,168
598,Dec 1 1994,CECAFA Cup in Kenya,Somalia,Djibouti,1174,901,2,1,7,-7,1181,894,155,198,2,-1,157,197,40,0,273
599,Dec 1 1994,CECAFA Cup in Kenya,Uganda,Seychelles,1460,930,2,0,3,-3,1463,927,86,194,1,0,87,194,40,0,530
600,Dec 3 1994,CECAFA Cup in Kenya,Eritrea,Uganda,1235,1463,0,0,12,-12,1247,1451,139,91,3,-2,142,89,40,0,-228
601,Dec 3 1994,CECAFA Cup in Kenya,Tanzania,Djibouti,1417,894,3,0,3,-3,1420,891,100,199,1,-1,101,198,40,0,523
602,Dec 4 1994,Simba Cup in South Africa,Ghana,Ivory Coast,1649,1671,1,1,1,-1,1650,1670,39,35,1,0,40,35,20,0,-22
603,Dec 4 1994,Simba Cup in South Africa,South Africa,Cameroon,1661,1575,1,1,-7,7,1654,1582,38,62,0,0,38,62,30,100,186
604,Dec 4 1994,Friendly in Togo,Togo,Burkina Faso,1347,1426,2,0,14,-14,1361,1412,118,110,0,-7,118,103,20,100,21
605,Dec 5 1994,CECAFA Cup in Kenya,Kenya,Uganda,1427,1451,0,1,-24,24,1403,1475,115,81,-10,4,105,85,40,100,76
606,Dec 5 1994,CECAFA Cup in Kenya,Tanzania,Eritrea,1420,1247,1,0,11,-11,1431,1236,90,148,5,-3,95,145,40,0,173
607,Dec 8 1994,CECAFA Cup in Kenya,Kenya,Eritrea,1403,1236,1,0,7,-7,1410,1229,103,151,1,-3,104,148,40,100,267
608,Dec 8 1994,Friendly in Saudi Arabia,Saudi Arabia,Poland,1684,1686,0,2,-19,19,1665,1705,40,29,-4,1,36,30,20,100,98
609,Dec 8 1994,CECAFA Cup in Kenya,Tanzania,Uganda,1431,1475,2,2,3,-3,1434,1472,95,85,0,0,95,85,40,0,-44
610,Dec 10 1994,Friendly in Namibia,Namibia,Ivory Coast,1142,1670,2,1,18,-18,1160,1652,158,42,4,-4,162,38,20,100,-428
611,Dec 10 1994,Friendly in Saudi Arabia,Saudi Arabia,Poland,1665,1705,1,2,-12,12,1653,1717,38,30,-1,0,37,30,20,100,60
612,Dec 11 1994,Friendly in the United States,United States,Honduras,1621,1526,1,1,-5,5,1616,1531,52,68,-2,2,50,70,20,100,195
613,Dec 13 1994,European Championship qual in Turkey,France,Azerbaijan,1903,1485,2,0,5,-5,1908,1480,10,85,0,-1,10,84,40,0,418
614,Dec 14 1994,European Championship qual in Albania,Albania,Georgia,1372,1607,0,1,-13,13,1359,1620,124,40,-6,7,118,47,40,100,-135
615,Dec 14 1994,European Championship qual in Finland,Finland,San Marino,1522,1011,4,1,2,-2,1524,1009,73,190,0,-1,73,189,20,0,511
616,Dec 14 1994,European Championship qual in Israel,Israel,Romania,1609,1914,1,1,11,-11,1620,1903,42,12,5,-2,47,10,30,0,-305
617,Dec 14 1994,European Championship qual in Malta,Malta,Norway,1408,1869,0,1,-4,4,1404,1873,105,14,0,1,105,15,40,100,-361
618,Dec 14 1994,Friendly in Mexico,Mexico,Hungary,1866,1612,5,1,4,-4,1870,1608,17,57,0,-3,17,54,20,100,354
619,Dec 14 1994,European Championship qual in Moldova,Moldova,Germany,1541,1988,0,3,-8,8,1533,1996,70,2,-1,0,69,2,40,100,-347
620,Dec 14 1994,European Championship qual in the Netherlands,Netherlands,Luxembourg,1957,1157,5,0,0,0,1957,1157,5,163,0,0,5,163,20,0,800
621,Dec 14 1994,European Championship qual in Turkey,Turkey,Switzerland,1632,1857,1,2,-13,13,1619,1870,56,14,-6,3,50,17,40,100,-125
622,Dec 14 1994,European Championship qual in Wales,Wales,Bulgaria,1676,1827,0,3,-30,30,1646,1857,49,20,-8,1,41,21,40,100,-51
623,Dec 16 1994,Friendly in Tunisia,Tunisia,Algeria,1574,1598,1,0,8,-8,1582,1590,61,60,1,-1,62,59,20,100,76
624,Dec 17 1994,European Championship qual in Belgium,Belgium,Spain,1794,1967,1,4,-28,28,1766,1995,30,2,-3,1,27,3,40,100,-73
625,Dec 17 1994,European Championship qual in Macedonia,Macedonia,Cyprus,1626,1369,3,0,8,-8,1634,1361,42,120,1,-4,43,116,40,100,357
626,Dec 17 1994,Friendly in Saudi Arabia,Saudi Arabia,Costa Rica,1653,1617,1,3,-21,21,1632,1638,54,31,-9,10,45,41,20,100,136
627,Dec 18 1994,Friendly in Cameroon,Cameroon,Togo,1582,1361,1,1,-7,7,1575,1368,64,108,-1,4,63,112,20,100,321
628,Dec 18 1994,European Championship qual in Germany,Germany,Albania,1996,1359,2,1,1,-1,1997,1358,2,118,0,0,2,118,30,0,637
629,Dec 18 1994,European Championship qual in Greece,Greece,Scotland,1624,1783,1,0,23,-23,1647,1760,33,30,7,-3,40,27,40,100,-59
630,Dec 18 1994,European Championship qual in Portugal,Portugal,Liechtenstein,1863,1095,8,0,1,-1,1864,1094,20,176,0,0,20,176,20,0,768
631,Dec 21 1994,Friendly in Italy,Italy,Turkey,1983,1619,3,1,2,-2,1985,1617,4,51,0,0,4,51,20,100,464
632,Dec 23 1994,Friendly in Brazil,Brazil,Yugoslavia,2063,1932,2,0,6,-6,2069,1926,1,7,0,0,1,7,20,100,231
633,Dec 25 1994,Friendly in Mali,Mali,Mauritania,1466,1104,0,0,-9,9,1457,1113,89,167,-1,2,88,169,20,100,462
634,Dec 27 1994,Friendly in Argentina,Argentina,Yugoslavia,1875,1926,1,0,9,-9,1884,1917,14,7,0,0,14,7,20,100,49
635,Dec 29 1994,Friendly in Liberia,Liberia,Guinea,1362,1380,0,0,-2,2,1360,1382,118,109,-1,0,117,109,20,100,82
636,Dec 29 1994,Friendly in Mali,Mali,Mauritania,1457,1113,0,0,-9,9,1448,1122,94,167,-3,1,91,168,20,100,444
637,Dec 29 1994,Friendly in Saudi Arabia,Saudi Arabia,Zambia,1632,1664,1,0,8,-8,1640,1656,38,34,4,0,42,34,20,100,68
