,date,tournament,home_team,away_team,home_team_rating,away_team_rating,home_goals,away_goals,home_team_rating_change,away_team_rating_change,home_team_new_rating,away_team_new_rating,home_team_rank,away_team_rank,home_team_rank_change,away_team_rank_change,home_team_new_rank,away_team_new_rank,k,hadv,rdiff
0,1992,Friendly in Syria,Syria,Jordan,1478,1269,1,0,3,-3,1481,1266,75,127,0,-1,75,126,20,100,309
1,Jan 1992,Friendly in Guyana,Guyana,Barbados,1193,1339,0,2,-13,13,1180,1352,156,99,-5,6,151,105,20,100,-46
2,Jan 1992,Friendly in Guyana,Guyana,Barbados,1180,1352,0,2,-12,12,1168,1364,156,99,-5,6,151,105,20,100,-72
3,Jan 4 1992,Friendly in Egypt,Egypt,Czechoslovakia,1687,1879,2,0,19,-19,1706,1860,33,13,1,0,34,13,20,100,-92
4,Jan 5 1992,Friendly in Zaire,Zaire,Ivory Coast,1532,1684,2,0,17,-17,1549,1667,52,40,6,-2,58,38,20,100,-52
5,Jan 7 1992,Friendly in Egypt,Egypt,Norway,1706,1723,0,0,-2,2,1704,1725,34,30,0,0,34,30,20,100,83
6,Jan 9 1992,Friendly in Qatar,Qatar,Thailand,1475,1330,1,1,-6,6,1469,1336,77,111,0,1,77,112,20,100,245
7,Jan 12 1992,African Nations Cup in Senegal,Cameroon,Morocco,1679,1603,1,0,20,-20,1699,1583,34,60,1,-5,35,55,50,0,76
8,Jan 12 1992,Friendly in Qatar,Qatar,Thailand,1469,1336,4,0,8,-8,1477,1328,75,114,1,-1,76,113,20,100,233
9,Jan 12 1992,African Nations Cup in Senegal,Senegal,Nigeria,1566,1598,1,2,-30,30,1536,1628,67,41,-5,5,62,46,50,100,68
10,Jan 13 1992,African Nations Cup in Senegal,Ivory Coast,Algeria,1667,1755,3,0,55,-55,1722,1700,22,41,8,-7,30,34,50,0,-88
11,Jan 13 1992,African Nations Cup in Senegal,Zambia,Egypt,1632,1704,1,0,30,-30,1662,1674,37,42,4,-4,41,38,50,0,-72
12,Jan 14 1992,African Nations Cup in Senegal,Morocco,Zaire,1583,1549,1,1,-2,2,1581,1551,55,57,0,0,55,57,40,0,34
13,Jan 14 1992,African Nations Cup in Senegal,Nigeria,Kenya,1628,1469,2,1,14,-14,1642,1455,44,82,1,-2,45,80,50,0,159
14,Jan 15 1992,African Nations Cup in Senegal,Congo,Ivory Coast,1491,1722,0,0,15,-15,1506,1707,65,36,3,-3,68,33,50,0,-231
15,Jan 15 1992,African Nations Cup in Senegal,Ghana,Zambia,1532,1662,1,0,34,-34,1566,1628,49,51,8,-5,57,46,50,0,-130
16,Jan 15 1992,Friendly in Portugal,Portugal,Spain,1794,1826,0,0,-2,2,1792,1828,21,17,0,0,21,17,20,100,68
17,Jan 16 1992,African Nations Cup in Senegal,Cameroon,Zaire,1699,1551,1,1,-10,10,1689,1561,37,58,-1,0,36,58,50,0,148
18,Jan 16 1992,African Nations Cup in Senegal,Senegal,Kenya,1536,1455,3,0,23,-23,1559,1432,55,90,4,-5,59,85,50,100,181
19,Jan 17 1992,African Nations Cup in Senegal,Algeria,Congo,1700,1506,1,1,-13,13,1687,1519,38,66,-2,1,36,67,50,0,194
20,Jan 17 1992,African Nations Cup in Senegal,Ghana,Egypt,1566,1674,1,0,33,-33,1599,1641,45,50,6,-6,51,44,50,0,-108
21,Jan 19 1992,African Nations Cup in Senegal,Nigeria,Zaire,1642,1561,1,0,19,-19,1661,1542,41,62,1,-2,42,60,50,0,81
22,Jan 19 1992,African Nations Cup in Senegal,Senegal,Cameroon,1559,1689,0,1,-23,23,1536,1712,67,31,-4,2,63,33,50,100,-30
23,Jan 20 1992,African Nations Cup in Senegal,Ghana,Congo,1599,1519,2,1,19,-19,1618,1500,45,69,3,-1,48,68,50,0,80
24,Jan 20 1992,African Nations Cup in Senegal,Ivory Coast,Zambia,1707,1628,1,0,19,-19,1726,1609,24,56,5,-5,29,51,50,0,79
25,Jan 23 1992,African Nations Cup in Senegal,Cameroon,Ivory Coast,1712,1726,0,0,1,-1,1713,1725,34,29,0,0,34,29,30,0,-14
26,Jan 23 1992,African Nations Cup in Senegal,Ghana,Nigeria,1618,1661,2,1,28,-28,1646,1633,38,50,5,-4,43,46,50,0,-43
27,Jan 25 1992,African Nations Cup in Senegal,Nigeria,Cameroon,1633,1713,2,1,31,-31,1664,1682,32,38,7,-2,39,36,50,0,-80
28,Jan 25 1992,Friendly in the United States,United States,Comm of Indep States,1696,1922,0,1,-7,7,1689,1929,33,9,1,0,34,9,20,100,-126
29,Jan 26 1992,Friendly in Australia,Australia,Sweden,1676,1829,0,0,2,-2,1678,1827,37,18,0,-1,37,17,20,100,-53
30,Jan 26 1992,African Nations Cup in Senegal,Ghana,Ivory Coast,1646,1725,0,0,6,-6,1652,1719,42,33,1,-2,43,31,50,0,-79
31,Jan 29 1992,Friendly in Albania,Albania,Greece,1437,1663,1,0,13,-13,1450,1650,82,46,0,-3,82,43,20,100,-126
32,Jan 29 1992,Friendly in Australia,Australia,Sweden,1678,1827,1,0,11,-11,1689,1816,31,19,3,-1,34,18,20,100,-49
33,Jan 29 1992,Friendly in El Salvador,El Salvador,Comm of Indep States,1408,1929,0,3,-3,3,1405,1932,94,9,-1,0,93,9,20,100,-421
34,Jan 29 1992,Friendly in the United Arab Emirates,United Arab Emirates,Switzerland,1437,1775,0,2,-6,6,1431,1781,88,22,-3,1,85,23,20,100,-238
35,Feb 2 1992,Friendly in Australia,Australia,Sweden,1689,1816,1,0,11,-11,1700,1805,36,20,-1,-1,35,19,20,100,-27
36,Feb 2 1992,Friendly in the United States,United States,Comm of Indep States,1689,1932,2,1,14,-14,1703,1918,34,9,0,0,34,9,20,100,-143
37,Feb 4 1992,Friendly in Bermuda,Bermuda,Norway,1379,1725,1,3,-6,6,1373,1731,105,29,-2,0,103,29,20,100,-246
38,Feb 10 1992,Friendly tournament in Malta,Malta,Iceland,1400,1592,1,0,19,-19,1419,1573,81,58,7,-2,88,56,30,100,-92
39,Feb 12 1992,Friendly in Costa Rica,Costa Rica,United States,1591,1703,0,0,0,0,1591,1703,54,34,0,0,54,34,20,100,-12
40,Feb 12 1992,Friendly in Greece,Greece,Romania,1650,1809,1,0,12,-12,1662,1797,37,22,3,-2,40,20,20,100,-59
41,Feb 12 1992,Friendly in Israel,Israel,Comm of Indep States,1621,1918,1,2,-5,5,1616,1923,48,9,0,0,48,9,20,100,-197
42,Feb 12 1992,Friendly in Portugal,Portugal,Netherlands,1792,1963,2,0,18,-18,1810,1945,15,8,3,-1,18,7,20,100,-71
43,Feb 12 1992,Friendly in Turkey,Turkey,Finland,1567,1612,1,1,-2,2,1565,1614,57,48,0,1,57,49,20,100,55
44,Feb 18 1992,Friendly in El Salvador,El Salvador,United States,1405,1703,2,0,23,-23,1428,1680,78,40,8,-3,86,37,20,100,-198
45,Feb 19 1992,Friendly in England,England,France,1987,2009,2,0,12,-12,1999,1997,1,4,1,-1,2,3,20,100,78
46,Feb 19 1992,Friendly in Ireland,Ireland,Wales,1911,1797,0,1,-15,15,1896,1812,10,16,0,2,10,18,20,100,214
47,Feb 19 1992,Friendly in Italy,Italy,San Marino,1971,999,4,0,0,0,1971,999,5,177,0,0,5,177,20,0,972
48,Feb 19 1992,Friendly in Scotland,Scotland,Northern Ireland,1754,1662,1,0,5,-5,1759,1657,27,44,0,-2,27,42,20,100,192
49,Feb 19 1992,Friendly in Spain,Spain,Comm of Indep States,1828,1923,1,1,0,0,1828,1923,16,9,0,0,16,9,20,100,5
50,Feb 22 1992,Friendly in Tunisia,Tunisia,Nigeria,1538,1664,1,1,1,-1,1539,1663,62,39,0,0,62,39,20,100,-26
51,Feb 26 1992,Friendly in Brazil,Brazil,United States,1959,1680,3,0,4,-4,1963,1676,6,37,0,0,6,37,20,100,379
52,Feb 26 1992,Friendly in Tunisia,Tunisia,Belgium,1539,1819,2,1,15,-15,1554,1804,54,23,4,-3,58,20,20,100,-180
53,Mar 1 1992,Caribbean Cup qualifier in Saint Lucia,Saint Lucia,Guadeloupe,1291,1356,0,2,-33,33,1258,1389,138,87,-8,10,130,97,40,100,35
54,Mar 2 1992,Friendly in the United Arab Emirates,United Arab Emirates,Iceland,1431,1573,0,1,-9,9,1422,1582,89,54,-2,1,87,55,20,100,-42
55,Mar 3 1992,Friendly in Israel,Israel,Cyprus,1616,1257,2,1,1,-1,1617,1256,48,131,0,0,48,131,20,100,459
56,Mar 3 1992,Caribbean Cup qualifier in Saint Lucia,Saint Lucia,Dominica,1258,1145,1,1,-11,11,1247,1156,136,153,-3,0,133,153,40,100,213
57,Mar 4 1992,Caribbean Cup qualifier in Barbados,Barbados,Grenada,1364,1341,1,1,-7,7,1357,1348,108,110,-1,0,107,110,40,100,123
58,Mar 4 1992,Friendly in Costa Rica,Costa Rica,El Salvador,1591,1428,2,0,5,-5,1596,1423,52,87,1,-1,53,86,20,100,263
59,Mar 4 1992,Caribbean Cup qualifier in Barbados,Netherlands Antilles,St Vincent & Grenadines,1359,1341,2,2,-1,1,1358,1342,105,112,1,-1,106,111,20,0,18
60,Mar 5 1992,Caribbean Cup qualifier in Saint Lucia,Dominica,Guadeloupe,1156,1389,0,0,12,-12,1168,1377,149,105,2,-4,151,101,40,0,-233
61,Mar 6 1992,Caribbean Cup qualifier in Barbados,Barbados,Netherlands Antilles,1357,1358,1,0,14,-14,1371,1344,103,114,2,-4,105,110,40,100,99
62,Mar 6 1992,Caribbean Cup qualifier in Barbados,Grenada,St Vincent & Grenadines,1348,1342,0,0,0,0,1348,1342,108,111,1,0,109,111,20,0,6
63,Mar 8 1992,Caribbean Cup qualifier in Barbados,Barbados,St Vincent & Grenadines,1371,1342,2,3,-27,27,1344,1369,115,101,-5,5,110,106,40,100,129
64,Mar 8 1992,Caribbean Cup qualifier in Barbados,Netherlands Antilles,Grenada,1344,1348,1,0,20,-20,1364,1328,104,115,3,-3,107,112,40,0,-4
65,Mar 11 1992,Friendly in Spain,Spain,United States,1828,1676,2,0,6,-6,1834,1670,14,37,1,0,15,37,20,100,252
66,Mar 17 1992,Friendly in the United States,El Salvador,Honduras,1423,1665,1,1,6,-6,1429,1659,84,44,1,-3,85,41,20,0,-242
67,Mar 18 1992,Friendly in Morocco,Morocco,United States,1581,1670,3,1,15,-15,1596,1655,50,47,3,-5,53,42,20,100,11
68,Mar 21 1992,World Cup qualifier in the Dominican Republic,Dominican Republic,Puerto Rico,1013,909,1,2,-31,31,982,940,180,181,-2,1,178,182,40,100,204
69,Mar 22 1992,World Cup qualifier in Saint Lucia,Saint Lucia,St Vincent & Grenadines,1247,1369,1,0,21,-21,1268,1348,117,112,8,-3,125,109,40,100,-22
70,Mar 25 1992,Friendly in Cyprus,Cyprus,Greece,1256,1662,1,3,-4,4,1252,1666,134,36,-1,1,133,37,20,100,-306
71,Mar 25 1992,Friendly in Czechoslovakia,Czechoslovakia,England,1860,1999,2,2,1,-1,1861,1998,13,2,0,0,13,2,20,100,-39
72,Mar 25 1992,Friendly in France,France,Belgium,1997,1804,3,3,-7,7,1990,1811,3,16,0,2,3,18,20,100,293
73,Mar 25 1992,Friendly in Hungary,Hungary,Austria,1720,1614,2,1,5,-5,1725,1609,30,51,0,-1,30,50,20,100,206
74,Mar 25 1992,Friendly in Ireland,Ireland,Switzerland,1896,1781,2,1,4,-4,1900,1777,10,25,0,-1,10,24,20,100,215
75,Mar 25 1992,Friendly in Italy,Italy,Germany,1971,2087,1,0,10,-10,1981,2077,5,1,0,0,5,1,20,100,-16
76,Mar 25 1992,Friendly in Luxembourg,Luxembourg,Turkey,1173,1565,2,3,-3,3,1170,1568,150,57,0,0,150,57,20,100,-292
77,Mar 25 1992,Friendly in the Netherlands,Netherlands,Yugoslavia,1945,1943,2,0,11,-11,1956,1932,7,8,0,0,7,8,20,100,102
78,Mar 25 1992,Friendly in Scotland,Scotland,Finland,1759,1614,1,1,-6,6,1753,1620,27,47,0,1,27,48,20,100,245
79,Mar 28 1992,World Cup qualifier in Puerto Rico,Puerto Rico,Dominican Republic,940,982,1,1,-3,3,937,985,182,178,0,0,182,178,40,100,58
80,Mar 29 1992,World Cup qualifier in St Vincent & Grenadines,St Vincent & Grenadines,Saint Lucia,1348,1268,3,1,16,-16,1364,1252,103,139,3,-7,106,132,40,100,180
81,Apr 1 1992,Caribbean Cup qualifier in Sint Maarten,Martinique,Cayman Islands,1418,1050,7,0,10,-10,1428,1040,81,175,5,-2,86,173,40,0,368
82,Apr 2 1992,Friendly in Canada,Canada,China,1533,1492,5,2,11,-11,1544,1481,57,77,4,-3,61,74,20,100,141
83,Apr 3 1992,Caribbean Cup qualifier in Sint Maarten,Sint Maarten,Cayman Islands,876,1040,4,2,35,-35,911,1005,180,177,4,-2,184,175,40,100,-64
84,Apr 4 1992,Friendly in the United States,United States,China,1655,1481,5,0,7,-7,1662,1474,36,80,3,-3,39,77,20,100,274
85,Apr 5 1992,Caribbean Cup qualifier in Sint Maarten,Sint Maarten,Martinique,911,1428,1,1,17,-17,928,1411,182,96,1,-5,183,91,40,100,-417
86,Apr 5 1992,Friendly in Togo,Togo,Ghana,1375,1652,1,0,15,-15,1390,1637,92,47,5,-2,97,45,20,100,-177
87,Apr 8 1992,Caribbean Cup qualifier in Suriname,French Guiana,Guyana,1263,1168,1,1,-5,5,1258,1173,131,149,-2,1,129,150,20,100,195
88,Apr 8 1992,Friendly in Israel,Israel,Iceland,1617,1582,2,2,-4,4,1613,1586,49,56,0,0,49,56,20,100,135
89,Apr 8 1992,Friendly in Romania,Romania,Latvia,1797,1419,2,0,2,-2,1799,1417,21,91,0,-1,21,90,20,100,478
90,Apr 8 1992,Caribbean Cup qualifier in Suriname,Suriname,Aruba,1383,1070,5,0,7,-7,1390,1063,95,169,2,0,97,169,40,100,413
91,Apr 8 1992,Friendly in Turkey,Turkey,Denmark,1568,1884,2,1,16,-16,1584,1868,57,12,0,0,57,12,20,100,-216
92,Apr 10 1992,Caribbean Cup qualifier in Suriname,French Guiana,Aruba,1258,1063,2,0,15,-15,1273,1048,115,173,7,-2,122,171,40,0,195
93,Apr 10 1992,Caribbean Cup qualifier in Suriname,Suriname,Guyana,1390,1173,4,0,10,-10,1400,1163,95,154,1,-2,96,152,40,100,317
94,Apr 12 1992,Caribbean Cup qualifier in Suriname,Guyana,Aruba,1163,1048,3,0,24,-24,1187,1024,140,175,6,-2,146,173,40,0,115
95,Apr 12 1992,Friendly in Jamaica,Jamaica,Bermuda,1351,1373,0,0,-2,2,1349,1375,109,102,0,1,109,103,20,100,78
96,Apr 12 1992,Caribbean Cup qualifier in Suriname,Suriname,French Guiana,1400,1273,3,2,9,-9,1409,1264,92,132,2,-5,94,127,40,100,227
97,Apr 14 1992,Friendly in Austria,Austria,Lithuania,1609,1176,4,0,2,-2,1611,1174,50,148,0,0,50,148,20,100,533
98,Apr 15 1992,Caribbean Cup qualifier in Saint Kitts and Nevis,Antigua and Barbuda,Montserrat,1219,592,5,0,2,-2,1221,590,137,204,1,0,138,204,30,0,627
99,Apr 15 1992,Friendly in Brazil,Brazil,Finland,1963,1620,3,1,2,-2,1965,1618,6,48,0,0,6,48,20,100,443
100,Apr 15 1992,Caribbean Cup qualifier in Saint Kitts and Nevis,Saint Kitts and Nevis,British Virgin Islands,1196,921,4,0,8,-8,1204,913,140,184,2,0,142,184,40,100,375
101,Apr 17 1992,Caribbean Cup qualifier in Saint Kitts and Nevis,Antigua and Barbuda,British Virgin Islands,1221,913,2,0,9,-9,1230,904,134,184,2,0,136,184,40,0,308
102,Apr 17 1992,Caribbean Cup qualifier in Saint Kitts and Nevis,Saint Kitts and Nevis,Montserrat,1204,590,10,0,2,-2,1206,588,140,204,1,0,141,204,30,0,614
103,Apr 18 1992,Caribbean Cup qualifier in Saint Kitts and Nevis,Saint Kitts and Nevis,Antigua and Barbuda,1206,1230,0,1,-24,24,1182,1254,151,126,-5,5,146,131,40,100,76
104,Apr 19 1992,World Cup qualifier in Barbados,Barbados,Trinidad and Tobago,1344,1476,1,2,-18,18,1326,1494,116,64,-3,6,113,70,40,100,-32
105,Apr 19 1992,World Cup qualifier in the Netherlands Antilles,Netherlands Antilles,Antigua and Barbuda,1364,1254,1,1,-11,11,1353,1265,110,123,-2,4,108,127,40,100,210
106,Apr 19 1992,Asian Cup qualifier in Singapore,Singapore,Malaysia,1260,1211,1,1,-8,8,1252,1219,136,140,-4,0,132,140,40,100,149
107,Apr 20 1992,Asian Cup qualifier in Singapore,China,Indonesia,1474,1266,2,0,14,-14,1488,1252,67,137,5,-6,72,131,40,0,208
108,Apr 22 1992,World Cup qualifier in Belgium,Belgium,Cyprus,1811,1252,1,0,1,-1,1812,1251,16,135,1,-2,17,133,20,0,559
109,Apr 22 1992,Friendly in Czechoslovakia,Czechoslovakia,Germany,1861,2077,1,1,3,-3,1864,2074,13,1,0,0,13,1,20,100,-116
110,Apr 22 1992,Asian Cup qualifier in Singapore,Singapore,Indonesia,1252,1252,1,2,-26,26,1226,1278,145,113,-7,9,138,122,40,100,100
111,Apr 22 1992,World Cup qualifier in Spain,Spain,Albania,1834,1450,3,0,4,-4,1838,1446,15,82,0,0,15,82,40,100,484
112,Apr 22 1992,Friendly in Tunisia,Tunisia,Sweden,1554,1805,0,1,-6,6,1548,1811,60,18,-1,1,59,19,20,100,-151
113,Apr 23 1992,Asian Cup qualifier in Singapore,China,Malaysia,1488,1219,4,0,13,-13,1501,1206,64,140,4,0,68,140,40,0,269
114,Apr 25 1992,Asian Cup qualifier in Singapore,Indonesia,Malaysia,1278,1206,1,1,-4,4,1274,1210,122,140,0,0,122,140,40,0,72
115,Apr 26 1992,World Cup qualifier in Antigua and Barbuda,Antigua and Barbuda,Netherlands Antilles,1265,1353,3,0,34,-34,1299,1319,115,118,6,-5,121,113,40,100,12
116,Apr 26 1992,World Cup qualifier in Bermuda,Bermuda,Haiti,1375,1315,1,0,11,-11,1386,1304,95,120,4,-2,99,118,40,100,160
117,Apr 26 1992,World Cup qualifier in Guyana,Guyana,Suriname,1187,1409,1,2,-13,13,1174,1422,149,80,-2,7,147,87,40,100,-122
118,Apr 26 1992,Asian Cup qualifier in Singapore,Singapore,China,1226,1501,0,1,-11,11,1215,1512,140,66,-1,1,139,67,40,100,-175
119,Apr 28 1992,World Cup qualifier in Northern Ireland,Northern Ireland,Lithuania,1657,1174,2,2,-19,19,1638,1193,46,143,-2,2,44,145,40,100,583
120,Apr 28 1992,Friendly in Switzerland,Switzerland,Bulgaria,1777,1737,0,2,-21,21,1756,1758,30,24,-3,2,27,26,20,100,140
121,Apr 29 1992,Friendly in Austria,Austria,Wales,1611,1812,1,1,3,-3,1614,1809,48,23,1,-3,49,20,20,100,-101
122,Apr 29 1992,Friendly in the CIS,Comm of Indep States,England,1923,1998,2,2,-1,1,1922,1999,9,2,0,0,9,2,20,100,25
123,Apr 29 1992,Friendly in Denmark,Denmark,Norway,1868,1731,1,0,4,-4,1872,1727,12,31,0,-1,12,30,20,100,237
124,Apr 29 1992,Friendly in El Salvador,El Salvador,Costa Rica,1429,1596,1,1,2,-2,1431,1594,87,57,-1,-2,86,55,20,100,-67
125,Apr 29 1992,Friendly in Ireland,Ireland,United States,1900,1662,4,1,4,-4,1904,1658,10,43,0,-2,10,41,20,100,338
126,Apr 29 1992,Friendly in Ukraine,Ukraine,Hungary,1600,1725,1,3,-14,14,1586,1739,56,29,0,0,56,29,20,100,-25
127,Apr 30 1992,Friendly in Uruguay,Uruguay,Brazil,1841,1965,1,0,11,-11,1852,1954,14,8,0,-1,14,7,20,100,-24
128,May 2 1992,Caribbean Cup qualifier in Anguilla,Anguilla,Cuba,573,1493,0,3,-1,1,572,1494,206,71,0,1,206,72,40,100,-820
129,May 6 1992,World Cup qualifier in Romania,Romania,Faroe Islands,1799,1270,7,0,2,-2,1801,1268,21,128,0,-1,21,127,20,0,529
130,May 7 1992,Friendly in Sweden,Sweden,Poland,1811,1784,5,0,13,-13,1824,1771,16,24,1,-1,17,23,20,100,127
131,May 8 1992,Black Stars Tournament in France,Congo,Haiti,1500,1304,4,1,13,-13,1513,1291,66,127,2,-4,68,123,30,0,196
132,May 9 1992,Black Stars Tournament in France,Congo,Guadeloupe,1513,1377,1,1,-6,6,1507,1383,72,100,-2,2,70,102,20,100,236
133,May 9 1992,Caribbean Cup qualifier in Cuba,Cuba,Anguilla,1494,572,5,0,0,0,1494,572,72,206,0,0,72,206,20,0,922
134,May 9 1992,Asian Cup qualifier in India,India,Pakistan,1100,1037,2,0,17,-17,1117,1020,156,177,4,-2,160,175,40,100,163
135,May 11 1992,Asian Cup qualifier in India,Iran,Pakistan,1636,1020,7,0,3,-3,1639,1017,42,175,2,0,44,175,40,0,616
136,May 12 1992,Friendly in Hungary,Hungary,England,1739,1999,0,1,-6,6,1733,2005,29,2,0,0,29,2,20,100,-160
137,May 13 1992,World Cup qualifier in Greece,Greece,Iceland,1666,1586,1,0,10,-10,1676,1576,37,60,0,-2,37,58,40,100,180
138,May 13 1992,Asian Cup qualifier in India,India,Iran,1117,1639,0,3,-6,6,1111,1645,164,42,-2,1,162,43,40,100,-422
139,May 13 1992,Friendly in Norway,Norway,Faroe Islands,1727,1268,2,0,1,-1,1728,1267,30,127,0,0,30,127,20,100,559
140,May 14 1992,World Cup qualifier in Finland,Finland,Bulgaria,1618,1758,0,3,-31,31,1587,1789,62,18,-7,4,55,22,40,100,-40
141,May 14 1992,Friendly in Kuwait,Kuwait,Syria,1486,1481,0,0,-3,3,1483,1484,79,75,-2,1,77,76,20,100,105
142,May 14 1992,Friendly in the United Arab Emirates,United Arab Emirates,Qatar,1422,1477,1,0,9,-9,1431,1468,84,78,2,0,86,78,20,100,45
143,May 17 1992,Friendly in England,England,Brazil,2005,1954,1,1,-4,4,2001,1958,2,5,0,1,2,6,20,100,151
144,May 17 1992,Friendly in Qatar,Qatar,Kuwait,1468,1483,0,0,-2,2,1466,1485,80,75,-1,1,79,76,20,100,85
145,May 17 1992,Friendly in the United Arab Emirates,United Arab Emirates,Syria,1431,1484,2,0,13,-13,1444,1471,82,78,2,-1,84,77,20,100,47
146,May 17 1992,Friendly in the United States,United States,Scotland,1658,1753,0,1,-10,10,1648,1763,41,26,0,1,41,27,20,100,5
147,May 19 1992,Friendly in Austria,Austria,Poland,1614,1771,2,4,-13,13,1601,1784,52,22,-2,1,50,23,20,100,-57
148,May 19 1992,Friendly in Bahrain,Bahrain,Algeria,1382,1687,0,0,5,-5,1387,1682,96,35,4,0,100,35,20,100,-205
149,May 20 1992,Friendly in Canada,Canada,Scotland,1544,1763,1,3,-10,10,1534,1773,70,23,-4,2,66,25,20,100,-119
150,May 20 1992,Friendly in Moldova,Moldova,Lithuania,1486,1193,1,1,-8,8,1478,1201,77,140,-1,3,76,143,20,100,393
151,May 20 1992,World Cup qualifier in Romania,Romania,Wales,1801,1809,5,1,28,-28,1829,1781,13,26,4,-3,17,23,40,100,92
152,May 20 1992,Friendly in the United Arab Emirates,United Arab Emirates,Syria,1444,1471,0,0,-2,2,1442,1473,84,77,0,0,84,77,20,100,73
153,May 23 1992,World Cup qualifier in Jamaica,Jamaica,Puerto Rico,1349,937,2,1,2,-2,1351,935,109,183,0,0,109,183,20,0,412
154,May 24 1992,Friendly tournament in Ethiopia,Ethiopia,Sudan,1420,1383,5,1,18,-18,1438,1365,80,107,5,-2,85,105,30,100,137
155,May 24 1992,Friendly in Guatemala,Guatemala,Ecuador,1455,1662,1,1,3,-3,1458,1659,81,39,0,0,81,39,20,100,-107
156,May 24 1992,World Cup qualifier in Haiti,Haiti,Bermuda,1291,1386,2,1,20,-20,1311,1366,111,107,6,-3,117,104,40,100,5
157,May 24 1992,Asian Cup qualifier in the United Arab Emirates,Kuwait,Bahrain,1485,1387,2,0,22,-22,1507,1365,65,110,5,-5,70,105,40,0,98
158,May 24 1992,World Cup qualifier in Suriname,Suriname,Guyana,1422,1174,1,1,-15,15,1407,1189,103,145,-7,2,96,147,40,100,348
159,May 26 1992,World Cup qualifier in Ireland,Ireland,Albania,1904,1446,2,0,2,-2,1906,1444,10,83,0,0,10,83,20,0,458
160,May 26 1992,Friendly in Malta,Malta,Latvia,1419,1417,1,0,7,-7,1426,1410,90,95,0,-2,90,93,20,100,102
161,May 26 1992,Friendly tournament in Ethiopia,Nigeria,Sudan,1663,1365,2,1,5,-5,1668,1360,38,109,0,-2,38,107,30,0,298
162,May 27 1992,Friendly in Costa Rica,Costa Rica,Ecuador,1594,1659,2,1,9,-9,1603,1650,46,41,4,-1,50,40,20,100,35
163,May 27 1992,Friendly in the Netherlands,Netherlands,Austria,1956,1601,3,2,1,-1,1957,1600,7,52,0,-1,7,51,20,100,455
164,May 27 1992,Friendly in Poland,Poland,Czechoslovakia,1784,1864,1,0,9,-9,1793,1855,20,13,1,0,21,13,20,100,20
165,May 27 1992,Friendly in Sweden,Sweden,Hungary,1824,1733,2,1,5,-5,1829,1728,16,29,1,0,17,29,20,100,191
166,May 27 1992,Friendly in Switzerland,Switzerland,France,1756,1990,2,1,14,-14,1770,1976,24,7,2,-2,26,5,20,100,-134
167,May 27 1992,Asian Cup qualifier in the United Arab Emirates,United Arab Emirates,Kuwait,1442,1507,3,2,18,-18,1460,1489,78,78,3,-4,81,74,30,0,-65
168,May 28 1992,Friendly tournament in Ethiopia,Ethiopia,Nigeria,1438,1668,4,1,36,-36,1474,1632,69,54,8,-8,77,46,30,100,-130
169,May 29 1992,Asian Cup qualifier in Qatar,Qatar,Syria,1466,1473,4,2,22,-22,1488,1451,70,88,5,-5,75,83,40,100,93
170,May 30 1992,Friendly in Germany,Germany,Turkey,2074,1584,1,0,1,-1,2075,1583,1,57,0,0,1,57,20,0,490
171,May 30 1992,Friendly tournament in Japan,Japan,Argentina,1375,1982,0,1,-2,2,1373,1984,102,3,0,0,102,3,30,100,-507
172,May 30 1992,Friendly in the Netherlands,Netherlands,Wales,1957,1781,4,0,6,-6,1963,1775,5,25,1,-1,6,24,20,100,276
173,May 30 1992,World Cup qualifier in Puerto Rico,Puerto Rico,Jamaica,935,1351,0,1,-6,6,929,1357,183,105,0,2,183,107,40,100,-316
174,May 30 1992,Asian Cup qualifier in the United Arab Emirates,United Arab Emirates,Bahrain,1460,1365,3,1,15,-15,1475,1350,75,113,3,-4,78,109,40,100,195
175,May 30 1992,US Cup in the United States,United States,Ireland,1648,1906,3,1,32,-32,1680,1874,34,12,3,-1,37,11,30,100,-158
176,May 31 1992,US Cup in the United States,Italy,Portugal,1981,1810,0,0,-7,7,1974,1817,6,18,-1,1,5,19,20,100,271
177,May 31 1992,Asian Cup qualifier in Qatar,Qatar,Oman,1488,1089,4,0,4,-4,1492,1085,73,167,1,0,74,167,40,100,499
178,May 31 1992,World Cup qualifier in Trinidad and Tobago,Trinidad and Tobago,Barbados,1494,1326,3,0,12,-12,1506,1314,70,119,1,-3,71,116,40,100,268
179,Jun 1992,Friendly tournament in North Korea,North Korea,Kazakhstan,1532,1600,3,1,20,-20,1552,1580,60,58,0,0,60,58,30,100,32
180,Jun 1 1992,Friendly tournament in Kazakhstan,Kazakhstan,Turkmenistan,1580,1500,1,0,8,-8,1588,1492,55,75,0,0,55,75,20,0,80
181,Jun 2 1992,Friendly in Germany,Germany,Northern Ireland,2075,1638,1,1,-9,9,2066,1647,1,38,0,3,1,41,20,0,437
182,Jun 2 1992,Asian Cup qualifier in Qatar,Syria,Oman,1451,1085,1,0,4,-4,1455,1081,85,171,0,-1,85,170,40,0,366
183,Jun 3 1992,World Cup qualifier in Albania,Albania,Lithuania,1444,1201,1,0,5,-5,1449,1196,87,149,0,-2,87,147,40,100,343
184,Jun 3 1992,Friendly tournament in Japan,Argentina,Wales,1984,1775,1,0,7,-7,1991,1768,3,28,0,-2,3,26,30,0,209
185,Jun 3 1992,Friendly in Denmark,Denmark,Comm of Indep States,1872,1922,1,1,-1,1,1871,1923,12,9,0,0,12,9,20,100,50
186,Jun 3 1992,Friendly in Estonia,Estonia,Slovenia,1197,1595,1,1,7,-7,1204,1588,143,56,2,-1,145,55,20,100,-298
187,Jun 3 1992,World Cup qualifier in the Faroe Islands,Faroe Islands,Belgium,1267,1812,0,3,-5,5,1262,1817,133,18,-2,1,131,19,40,100,-445
188,Jun 3 1992,Friendly in Finland,Finland,England,1587,2001,1,2,-3,3,1584,2004,60,2,-2,0,58,2,20,100,-314
189,Jun 3 1992,Asian Cup qualifier in North Korea,Hong Kong,Macao,1257,1022,2,2,-12,12,1245,1034,139,174,-3,1,136,175,40,0,235
190,Jun 3 1992,World Cup qualifier in Hungary,Hungary,Iceland,1728,1576,1,2,-32,32,1696,1608,41,41,-6,9,35,50,40,100,252
191,Jun 3 1992,Asian Cup qualifier in North Korea,North Korea,Taiwan,1552,1131,6,0,4,-4,1556,1127,60,159,0,0,60,159,40,100,521
192,Jun 3 1992,Friendly in Norway,Norway,Scotland,1728,1773,0,0,-2,2,1726,1775,29,23,0,1,29,24,20,100,55
193,Jun 3 1992,US Cup in the United States,United States,Portugal,1680,1817,1,0,17,-17,1697,1800,31,21,3,-1,34,20,30,100,-37
194,Jun 4 1992,US Cup in the United States,Italy,Ireland,1974,1874,2,0,16,-16,1990,1858,3,13,1,-1,4,12,30,0,100
195,Jun 5 1992,Friendly in France,France,Netherlands,1976,1963,1,1,-3,3,1973,1966,5,6,0,0,5,6,20,100,113
196,Jun 5 1992,Asian Cup qualifier in North Korea,Hong Kong,Taiwan,1245,1127,0,0,-7,7,1238,1134,138,157,-1,1,137,158,40,0,118
197,Jun 5 1992,Asian Cup qualifier in North Korea,North Korea,Macao,1556,1034,2,0,2,-2,1558,1032,60,175,0,0,60,175,30,0,522
198,Jun 6 1992,US Cup in the United States,United States,Italy,1697,1990,1,1,8,-8,1705,1982,32,4,1,0,33,4,30,100,-193
199,Jun 7 1992,Friendly in Guatemala,Guatemala,Nicaragua,1458,976,7,1,1,-1,1459,975,82,182,1,0,83,182,20,100,582
200,Jun 7 1992,US Cup in the United States,Ireland,Portugal,1858,1800,2,0,19,-19,1877,1781,10,24,1,-2,11,22,30,0,58
201,Jun 7 1992,Friendly tournament in Japan,Japan,Wales,1373,1768,0,1,-5,5,1368,1773,106,24,-1,1,105,25,30,100,-295
202,Jun 7 1992,Asian Cup qualifier in North Korea,Macao,Taiwan,1032,1134,2,0,39,-39,1071,1095,169,178,3,-10,172,168,40,0,-102
203,Jun 7 1992,World Cup qualifier in New Zealand,New Zealand,Fiji,1510,1462,3,0,21,-21,1531,1441,68,91,1,-4,69,87,40,100,148
204,Jun 7 1992,Asian Cup qualifier in North Korea,North Korea,Hong Kong,1558,1238,0,0,-17,17,1541,1255,68,129,-4,4,64,133,40,100,420
205,Jun 10 1992,European Championship in Sweden,Sweden,France,1829,1973,1,1,3,-3,1832,1970,15,5,1,0,16,5,40,100,-44
206,Jun 11 1992,European Championship in Sweden,Denmark,England,1871,2004,0,0,9,-9,1880,1995,10,2,1,0,11,2,50,0,-133
207,Jun 12 1992,European Championship in Sweden,Comm of Indep States,Germany,1923,2066,1,1,10,-10,1933,2056,7,1,1,0,8,1,50,0,-143
208,Jun 12 1992,European Championship in Sweden,Netherlands,Scotland,1966,1775,1,0,12,-12,1978,1763,4,32,1,-4,5,28,50,0,191
209,Jun 13 1992,Friendly tournament in Canada,Canada,Hong Kong,1534,1255,3,1,5,-5,1539,1250,64,139,2,-3,66,136,20,0,279
210,Jun 13 1992,Friendly in the United States,United States,Australia,1705,1700,0,1,-13,13,1692,1713,37,32,-2,1,35,33,20,100,105
211,Jun 14 1992,World Cup qualifier in Antigua and Barbuda,Antigua and Barbuda,Bermuda,1299,1366,0,3,-38,38,1261,1404,138,94,-7,6,131,100,40,100,33
212,Jun 14 1992,European Championship in Sweden,England,France,1995,1970,0,0,-2,2,1993,1972,2,6,0,0,2,6,50,0,25
213,Jun 14 1992,Friendly in Gabon,Gabon,Togo,1408,1390,1,0,7,-7,1415,1383,89,105,4,-2,93,103,20,100,118
214,Jun 14 1992,African Nations Cup qualifier in Guinea-Bissau,Guinea-Bissau,Cape Verde,1311,1319,3,1,22,-22,1333,1297,107,131,6,-8,113,123,40,100,92
215,Jun 14 1992,African Nations Cup qualifier in Lesotho,Lesotho,Botswana,1141,1118,0,0,-7,7,1134,1125,157,158,0,1,157,159,40,100,123
216,Jun 14 1992,European Championship in Sweden,Sweden,Denmark,1832,1880,1,0,21,-21,1853,1859,12,13,2,-1,14,12,50,100,52
217,Jun 15 1992,European Championship in Sweden,Comm of Indep States,Netherlands,1933,1978,0,0,3,-3,1936,1975,8,5,0,0,8,5,40,0,-45
218,Jun 15 1992,European Championship in Sweden,Germany,Scotland,2056,1763,2,0,12,-12,2068,1751,1,28,0,0,1,28,50,0,293
219,Jun 16 1992,World Cup qualifier in the Faroe Islands,Faroe Islands,Cyprus,1262,1251,0,2,-39,39,1223,1290,150,115,-10,10,140,125,40,100,111
220,Jun 17 1992,European Championship in Sweden,Denmark,France,1859,1972,2,1,33,-33,1892,1939,8,8,2,-1,10,7,50,0,-113
221,Jun 17 1992,Caribbean Cup in Trinidad and Tobago,Martinique,Suriname,1411,1407,4,1,35,-35,1446,1372,82,114,6,-8,88,106,40,0,4
222,Jun 17 1992,European Championship in Sweden,Sweden,England,1853,1993,2,1,28,-28,1881,1965,10,8,2,-3,12,5,40,0,-140
223,Jun 17 1992,Friendly tournament in Tajikistan,Tajikistan,Uzbekistan,1400,1700,2,2,8,-8,1408,1692,99,35,0,0,99,35,30,100,-200
224,Jun 17 1992,Caribbean Cup in Trinidad and Tobago,Trinidad and Tobago,Antigua and Barbuda,1506,1261,7,0,11,-11,1517,1250,70,141,1,-5,71,136,40,100,345
225,Jun 18 1992,Friendly in Argentina,Argentina,Australia,1991,1713,2,0,3,-3,1994,1710,4,33,-1,0,3,33,20,100,378
226,Jun 18 1992,Caribbean Cup in Trinidad and Tobago,Cuba,Guadeloupe,1494,1383,2,0,21,-21,1515,1362,69,114,3,-5,72,109,40,0,111
227,Jun 18 1992,Caribbean Cup in Trinidad and Tobago,Jamaica,St Vincent & Grenadines,1357,1364,2,0,31,-31,1388,1333,95,119,8,-5,103,114,40,0,-7
228,Jun 18 1992,European Championship in Sweden,Netherlands,Germany,1975,2068,3,1,47,-47,2022,2021,-2,3,3,-1,1,2,50,0,-93
229,Jun 18 1992,European Championship in Sweden,Scotland,Comm of Indep States,1751,1936,3,0,65,-65,1816,1871,12,18,8,-5,20,13,50,0,-185
230,Jun 19 1992,Caribbean Cup in Trinidad and Tobago,Antigua and Barbuda,Suriname,1250,1372,1,1,7,-7,1257,1365,132,110,2,-2,134,108,40,0,-122
231,Jun 19 1992,Asian Cup qualifier in Thailand,South Korea,Bangladesh,1715,1080,6,0,2,-2,1717,1078,31,173,0,0,31,173,30,0,635
232,Jun 19 1992,Caribbean Cup in Trinidad and Tobago,Trinidad and Tobago,Martinique,1517,1446,2,1,11,-11,1528,1435,71,90,0,-1,71,89,40,100,171
233,Jun 20 1992,Caribbean Cup in Trinidad and Tobago,Cuba,St Vincent & Grenadines,1515,1333,1,0,10,-10,1525,1323,72,120,0,-3,72,117,40,0,182
234,Jun 20 1992,Caribbean Cup in Trinidad and Tobago,Jamaica,Guadeloupe,1388,1362,1,0,19,-19,1407,1343,97,115,3,-3,100,112,40,0,26
235,Jun 20 1992,Friendly in Mozambique,Mozambique,Swaziland,1335,1196,4,1,7,-7,1342,1189,113,151,0,-1,113,150,20,100,239
236,Jun 21 1992,Friendly in Gabon,Gabon,Burundi,1415,1269,0,1,-16,16,1399,1285,109,126,-7,2,102,128,20,100,246
237,Jun 21 1992,Caribbean Cup in Trinidad and Tobago,Martinique,Antigua and Barbuda,1435,1257,4,1,18,-18,1453,1239,83,142,3,-4,86,138,40,0,178
238,Jun 21 1992,European Championship in Sweden,Sweden,Germany,1881,2021,2,3,-22,22,1859,2043,15,0,-2,1,13,1,50,100,-40
239,Jun 21 1992,Asian Cup qualifier in Thailand,Thailand,South Korea,1328,1717,2,1,34,-34,1362,1683,101,41,7,-5,108,36,40,100,-289
240,Jun 21 1992,Caribbean Cup in Trinidad and Tobago,Trinidad and Tobago,Suriname,1528,1365,1,0,7,-7,1535,1358,67,112,2,-2,69,110,40,100,263
241,Jun 21 1992,Friendly in Uruguay,Uruguay,Australia,1852,1710,2,0,6,-6,1858,1704,13,31,1,1,14,32,20,100,242
242,Jun 22 1992,Caribbean Cup in Trinidad and Tobago,Cuba,Jamaica,1525,1407,0,0,-7,7,1518,1414,72,91,0,4,72,95,40,0,118
243,Jun 22 1992,European Championship in Sweden,Denmark,Netherlands,1892,2022,2,2,9,-9,1901,2013,9,2,0,0,9,2,50,0,-130
244,Jun 22 1992,Caribbean Cup in Trinidad and Tobago,Guadeloupe,St Vincent & Grenadines,1343,1323,1,0,19,-19,1362,1304,103,127,5,-5,108,122,40,0,20
245,Jun 23 1992,Asian Cup qualifier in Thailand,Thailand,Bangladesh,1362,1078,1,0,4,-4,1366,1074,108,173,0,0,108,173,40,100,384
246,Jun 24 1992,Caribbean Cup in Trinidad and Tobago,Jamaica,Martinique,1414,1453,1,0,22,-22,1436,1431,83,98,6,-6,89,92,40,0,-39
247,Jun 24 1992,Caribbean Cup in Trinidad and Tobago,Trinidad and Tobago,Cuba,1535,1518,1,0,14,-14,1549,1504,53,76,8,-2,61,74,30,0,17
248,Jun 26 1992,Caribbean Cup in Trinidad and Tobago,Cuba,Martinique,1504,1431,1,1,-4,4,1500,1435,74,86,0,3,74,89,40,0,73
249,Jun 26 1992,European Championship in Sweden,Denmark,Germany,1901,2043,2,0,52,-52,1953,1991,5,5,2,-2,7,3,50,0,-142
250,Jun 26 1992,Friendly tournament in Sudan,Sudan,Eritrea,1360,1200,1,1,-10,10,1350,1210,112,145,0,0,112,145,30,100,260
251,Jun 26 1992,Caribbean Cup in Trinidad and Tobago,Trinidad and Tobago,Jamaica,1549,1436,3,1,14,-14,1563,1422,61,101,0,-6,61,95,40,100,213
252,Jun 27 1992,Friendly in the United States,United States,Ukraine,1692,1586,0,0,-5,5,1687,1591,36,54,-1,2,35,56,20,100,206
253,Jun 27 1992,World Cup qualifier in Vanuatu,Vanuatu,New Zealand,1042,1531,1,4,-7,7,1035,1538,178,67,0,2,178,69,40,100,-389
254,Jun 28 1992,African Nations Cup qualifier in Botswana,Botswana,Lesotho,1125,1134,0,4,-47,47,1078,1181,186,150,-12,5,174,155,40,100,91
255,Jun 28 1992,African Nations Cup qualifier in Cape Verde,Cape Verde,Guinea-Bissau,1297,1333,1,0,16,-16,1313,1317,117,121,4,-3,121,118,40,100,64
256,Jun 28 1992,Friendly tournament in China,China,Slovakia,1512,1646,2,3,-14,14,1498,1660,75,41,0,0,75,41,30,100,-34
257,Jun 28 1992,Friendly tournament in Sudan,Eritrea,Chad,1210,1300,1,0,19,-19,1229,1281,139,134,3,-5,142,129,30,0,-90
258,Jun 28 1992,Friendly in Honduras,Honduras,Panama,1659,1292,4,0,2,-2,1661,1290,40,126,0,0,40,126,20,100,467
259,Jun 28 1992,Friendly tournament in Uzbekistan,Uzbekistan,Turkmenistan,1692,1492,2,1,5,-5,1697,1487,32,84,1,-4,33,80,20,0,200
260,Jun 30 1992,Friendly in Honduras,Honduras,Panama,1661,1290,4,0,2,-2,1663,1288,40,128,0,-1,40,127,20,100,471
261,Jun 30 1992,Friendly tournament in Sudan,Sudan,Chad,1350,1281,1,0,8,-8,1358,1273,109,131,2,-1,111,130,20,0,69
262,Jul 1 1992,World Cup qualifier in New Zealand,New Zealand,Vanuatu,1538,1035,8,0,3,-3,1541,1032,64,179,3,0,67,179,40,100,603
263,Jul 3 1992,Friendly tournament in North Korea,Kazakhstan,Libya,1588,1547,1,0,13,-13,1601,1534,50,79,4,-7,54,72,30,0,41
264,Jul 4 1992,World Cup qualifier in Bermuda,Bermuda,Antigua and Barbuda,1404,1239,2,1,7,-7,1411,1232,92,141,5,-1,97,140,40,100,265
265,Jul 4 1992,Friendly in Uruguay,Uruguay,Ecuador,1858,1650,3,1,4,-4,1862,1646,12,46,1,-2,13,44,20,100,308
266,Jul 5 1992,Friendly in Australia,Australia,Croatia,1704,1892,1,0,12,-12,1716,1880,30,10,1,0,31,10,20,100,-88
267,Jul 5 1992,Friendly in Guatemala,Guatemala,Poland,1459,1793,2,2,6,-6,1465,1787,85,23,0,-1,85,22,20,100,-234
268,Jul 5 1992,African Nations Cup qualifier in Guinea-Bissau,Guinea-Bissau,Cape Verde,1317,1313,1,0,14,-14,1331,1299,114,129,2,-4,116,125,40,100,104
269,Jul 5 1992,World Cup qualifier in Trinidad and Tobago,Trinidad and Tobago,Jamaica,1563,1422,1,2,-32,32,1531,1454,82,78,-10,9,72,87,40,100,241
270,Jul 6 1992,Friendly in Malawi,Malawi,Zimbabwe,1355,1433,0,0,-1,1,1354,1434,113,92,0,0,113,92,20,100,22
271,Jul 7 1992,Friendly in South Africa,South Africa,Cameroon,1781,1682,1,0,5,-5,1786,1677,23,39,0,-1,23,38,20,100,199
272,Jul 8 1992,Friendly in Australia,Australia,Croatia,1716,1880,3,1,18,-18,1734,1862,27,14,2,-2,29,12,20,100,-64
273,Jul 8 1992,Friendly in Honduras,Honduras,Colombia,1663,1766,1,0,10,-10,1673,1756,40,28,0,0,40,28,20,100,-3
274,Jul 8 1992,Friendly in Malawi,Malawi,Zimbabwe,1354,1434,0,0,-1,1,1353,1435,113,90,0,1,113,91,20,100,20
275,Jul 9 1992,Friendly in South Africa,South Africa,Cameroon,1786,1677,1,2,-15,15,1771,1692,27,32,-2,3,25,35,20,100,209
276,Jul 10 1992,Baltic Cup in Latvia,Latvia,Estonia,1410,1204,2,1,4,-4,1414,1200,95,151,2,-1,97,150,30,100,306
277,Jul 11 1992,Baltic Cup in Latvia,Estonia,Lithuania,1200,1196,1,1,0,0,1200,1196,150,151,0,0,150,151,20,0,4
278,Jul 11 1992,Friendly in Malawi,Malawi,Zimbabwe,1353,1435,1,0,9,-9,1362,1426,107,99,3,-4,110,95,20,100,18
279,Jul 11 1992,World Cup qualifier in the Solomon Islands,Solomon Islands,Tahiti,1237,1488,1,1,8,-8,1245,1480,137,79,1,0,138,79,40,100,-151
280,Jul 11 1992,Friendly in South Africa,South Africa,Cameroon,1771,1692,2,2,-5,5,1766,1697,29,31,-2,2,27,33,20,100,179
281,Jul 11 1992,Friendly tournament in Turkmenistan,Turkmenistan,Tajikistan,1487,1408,3,3,-7,7,1480,1415,78,93,1,4,79,97,30,100,179
282,Jul 12 1992,Friendly in Australia,Australia,Croatia,1734,1862,0,0,1,-1,1735,1861,29,14,0,-1,29,13,20,100,-28
283,Jul 12 1992,Baltic Cup in Latvia,Latvia,Lithuania,1414,1196,2,3,-26,26,1388,1222,110,139,-6,6,104,145,30,100,318
284,Jul 12 1992,Friendly in New Caledonia,New Caledonia,Tahiti,1271,1480,0,1,-7,7,1264,1487,133,79,-1,0,132,79,20,100,-109
285,Jul 13 1992,Friendly in Vanuatu,Vanuatu,Tahiti,1032,1487,2,1,18,-18,1050,1469,177,87,1,-4,178,83,20,100,-355
286,Jul 16 1992,Friendly tournament in Kazakhstan,Kazakhstan,Uzbekistan,1601,1697,1,0,15,-15,1616,1682,46,41,4,-4,50,37,30,100,4
287,Jul 19 1992,Friendly in Cameroon,Cameroon,Egypt,1697,1641,0,1,-14,14,1683,1655,37,38,-2,4,35,42,20,100,156
288,Jul 19 1992,World Cup qualifier in Guatemala,Guatemala,Honduras,1465,1673,0,0,6,-6,1471,1667,81,40,2,0,83,40,40,100,-108
289,Jul 19 1992,World Cup qualifier in Nicaragua,Nicaragua,El Salvador,975,1431,0,5,-9,9,966,1440,186,89,0,2,186,91,40,100,-356
290,Jul 20 1992,Friendly in Vanuatu,Vanuatu,Tahiti,1050,1469,1,2,-3,3,1047,1472,180,82,-1,1,179,83,20,100,-319
291,Jul 22 1992,Friendly in Cameroon,Cameroon,Egypt,1683,1655,0,1,-14,14,1669,1669,43,36,-4,3,39,39,20,100,128
292,Jul 22 1992,Friendly in New Caledonia,New Caledonia,Tahiti,1264,1472,1,2,-7,7,1257,1479,136,77,-2,3,134,80,20,100,-108
293,Jul 23 1992,World Cup qualifier in El Salvador,El Salvador,Nicaragua,1440,966,5,1,3,-3,1443,963,89,186,1,0,90,186,30,0,474
294,Jul 25 1992,Melanesian Cup in Vanuatu,Fiji,Solomon Islands,1441,1245,2,1,10,-10,1451,1235,85,140,3,-1,88,139,40,0,196
295,Jul 25 1992,Melanesian Cup in Vanuatu,Vanuatu,New Caledonia,1047,1257,0,1,-14,14,1033,1271,179,128,0,3,179,131,40,100,-110
296,Jul 26 1992,Friendly in El Salvador,El Salvador,Mexico,1443,1830,1,2,-3,3,1440,1833,91,17,0,0,91,17,20,100,-287
297,Jul 26 1992,World Cup qualifier in Honduras,Honduras,Guatemala,1667,1471,2,0,9,-9,1676,1462,35,86,3,-1,38,85,40,100,296
298,Jul 26 1992,Friendly in Ivory Coast,Ivory Coast,Egypt,1719,1669,2,0,9,-9,1728,1660,29,43,1,-2,30,41,20,100,150
299,Jul 27 1992,Melanesian Cup in Vanuatu,Vanuatu,Solomon Islands,1033,1235,1,3,-21,21,1012,1256,183,131,-2,4,181,135,40,100,-102
300,Jul 28 1992,Melanesian Cup in Vanuatu,Fiji,New Caledonia,1451,1271,2,2,-10,10,1441,1281,92,127,-2,2,90,129,30,100,280
301,Jul 28 1992,Friendly in Ivory Coast,Ivory Coast,Egypt,1728,1660,2,2,-4,4,1724,1664,32,41,-1,0,31,41,20,100,168
302,Jul 30 1992,Melanesian Cup in Vanuatu,New Caledonia,Solomon Islands,1281,1256,1,0,19,-19,1300,1237,121,143,4,-4,125,139,40,0,25
303,Jul 30 1992,Melanesian Cup in Vanuatu,Vanuatu,Fiji,1012,1441,0,2,-8,8,1004,1449,183,88,-1,1,182,89,40,100,-329
304,Jul 31 1992,Friendly tournament in the United States,Brazil,Mexico,1958,1833,5,0,20,-20,1978,1813,4,23,1,-3,5,20,30,0,125
305,Jul 31 1992,Friendly tournament in the United States,United States,Colombia,1687,1756,0,1,-16,16,1671,1772,44,22,-5,3,39,25,30,100,31
306,Aug 1 1992,Friendly in Lesotho,Lesotho,Namibia,1181,1174,2,0,11,-11,1192,1163,149,163,3,-3,152,160,20,100,107
307,Aug 1 1992,Friendly in Uruguay,Uruguay,Costa Rica,1862,1603,2,1,2,-2,1864,1601,12,54,0,0,12,54,20,100,359
308,Aug 2 1992,Friendly tournament in the United States,Colombia,Mexico,1772,1813,0,0,2,-2,1774,1811,23,20,1,0,24,20,30,0,-41
309,Aug 2 1992,Friendly in Lesotho,Lesotho,Namibia,1192,1163,2,2,-4,4,1188,1167,156,160,-2,0,154,160,20,100,129
310,Aug 2 1992,World Cup qualifier in Suriname,Suriname,St Vincent & Grenadines,1358,1304,0,0,-8,8,1350,1312,114,119,-1,2,113,121,40,100,154
311,Aug 2 1992,Friendly tournament in the United States,United States,Brazil,1671,1978,0,1,-7,7,1664,1985,41,3,-1,1,40,4,30,100,-207
312,Aug 5 1992,Friendly in the Faroe Islands,Faroe Islands,Israel,1223,1613,1,1,7,-7,1230,1606,138,55,3,-2,141,53,20,100,-290
313,Aug 6 1992,Friendly in Ecuador,Ecuador,Costa Rica,1646,1601,1,1,-4,4,1642,1605,47,54,-1,0,46,54,20,100,145
314,Aug 8 1992,Friendly tournament in Indonesia,Indonesia,Malaysia,1274,1210,1,1,-7,7,1267,1217,132,146,-1,1,131,147,30,100,164
315,Aug 8 1992,Friendly in Lesotho,Lesotho,Mauritius,1188,1259,1,0,9,-9,1197,1250,150,138,2,-2,152,136,20,100,29
316,Aug 9 1992,Friendly in Iceland,Iceland,Israel,1608,1606,0,2,-19,19,1589,1625,64,47,-6,3,58,50,20,100,102
317,Aug 9 1992,Friendly in Lesotho,Lesotho,Mauritius,1197,1250,2,2,-1,1,1196,1251,152,136,0,0,152,136,20,100,47
318,Aug 9 1992,Friendly in Libya,Libya,Niger,1534,1371,0,0,-6,6,1528,1377,73,107,-1,0,72,107,20,100,263
319,Aug 11 1992,Friendly tournament in Indonesia,Malaysia,Australia,1217,1735,1,0,29,-29,1246,1706,129,35,9,-3,138,32,30,0,-518
320,Aug 12 1992,Friendly in the United States,Honduras,El Salvador,1676,1440,3,0,7,-7,1683,1433,31,93,3,-1,34,92,20,0,236
321,Aug 12 1992,World Cup qualifier in Latvia,Latvia,Lithuania,1388,1222,1,2,-33,33,1355,1255,120,122,-8,12,112,134,40,100,266
322,Aug 12 1992,Friendly in Libya,Libya,Mali,1528,1395,0,1,-16,16,1512,1411,72,93,0,5,72,98,20,100,233
323,Aug 14 1992,African Nations Cup qualifier in Algeria,Algeria,Guinea-Bissau,1682,1331,3,1,4,-4,1686,1327,32,118,2,-1,34,117,20,0,351
324,Aug 14 1992,Friendly tournament in Indonesia,Indonesia,Australia,1267,1706,0,3,-7,7,1260,1713,135,32,-2,0,133,32,30,100,-339
325,Aug 14 1992,Friendly in Mali,Mali,Libya,1411,1512,2,1,10,-10,1421,1502,96,74,1,-1,97,73,20,100,-1
326,Aug 15 1992,African Nations Cup qualifier in Sudan,Sudan,Nigeria,1358,1632,0,0,9,-9,1367,1623,105,52,3,-2,108,50,40,100,-174
327,Aug 15 1992,African Nations Cup qualifier in Tanzania,Tanzania,Ghana,1307,1637,2,2,12,-12,1319,1625,113,49,5,-1,118,48,40,100,-230
328,Aug 15 1992,African Nations Cup qualifier in Uganda,Uganda,Ethiopia,1495,1474,3,1,20,-20,1515,1454,68,89,4,-3,72,86,40,100,121
329,Aug 15 1992,African Nations Cup qualifier in Zambia,Zambia,Mauritius,1609,1251,2,1,3,-3,1612,1248,52,139,0,-1,52,138,30,0,358
330,Aug 16 1992,African Nations Cup qualifier in Benin,Benin,Niger,1205,1377,1,2,-16,16,1189,1393,155,104,-3,1,152,105,40,100,-72
331,Aug 16 1992,African Nations Cup qualifier in Burkina Faso,Burkina Faso,Liberia,1428,1405,1,1,-7,7,1421,1412,98,98,-2,2,96,100,40,100,123
332,Aug 16 1992,African Nations Cup qualifier in Burundi,Burundi,Congo,1285,1507,1,0,27,-27,1312,1480,117,85,6,-6,123,79,40,100,-122
333,Aug 16 1992,African Nations Cup qualifier in Chad,Chad,Guinea,1273,1385,0,3,-34,34,1239,1419,150,92,-10,6,140,98,40,100,-12
334,Aug 16 1992,World Cup qualifier in Estonia,Estonia,Switzerland,1200,1770,0,6,-5,5,1195,1775,151,22,0,2,151,24,40,100,-470
335,Aug 16 1992,African Nations Cup qualifier in Gabon,Gabon,Cameroon,1399,1669,0,0,9,-9,1408,1660,105,41,-1,-1,104,40,40,100,-170
336,Aug 16 1992,World Cup qualifier in Jamaica,Jamaica,Trinidad and Tobago,1454,1531,1,1,-1,1,1453,1532,90,71,-2,0,88,71,20,100,23
337,Aug 16 1992,African Nations Cup qualifier in Lesotho,Lesotho,Kenya,1196,1432,2,2,7,-7,1203,1425,146,97,3,-2,149,95,40,100,-136
338,Aug 16 1992,African Nations Cup qualifier in Malawi,Malawi,Egypt,1362,1664,1,0,30,-30,1392,1634,102,52,4,-6,106,46,40,100,-202
339,Aug 16 1992,World Cup qualifier in Panama,Panama,Costa Rica,1288,1605,1,0,31,-31,1319,1574,108,69,10,-8,118,61,40,100,-217
340,Aug 16 1992,Friendly in Russia,Russia,Mexico,1871,1811,2,0,9,-9,1880,1802,9,20,1,0,10,20,20,100,160
341,Aug 16 1992,African Nations Cup qualifier in Senegal,Senegal,Togo,1536,1383,2,0,11,-11,1547,1372,61,109,4,-2,65,107,40,100,253
342,Aug 16 1992,African Nations Cup qualifier in Zaire,Zaire,Mozambique,1542,1342,2,0,9,-9,1551,1333,60,115,2,0,62,115,40,100,300
343,Aug 16 1992,African Nations Cup qualifier in Zimbabwe,Zimbabwe,South Africa,1426,1766,4,1,56,-56,1482,1710,61,36,17,-4,78,32,40,100,-240
344,Aug 18 1992,Friendly tournament in Jordan,Iraq,Ethiopia,1647,1454,13,0,22,-22,1669,1432,36,99,3,-6,39,93,30,0,193
345,Aug 18 1992,Friendly tournament in Jordan,Jordan,Sudan,1266,1367,3,0,26,-26,1292,1341,128,119,1,-5,129,114,30,100,-1
346,Aug 18 1992,Friendly tournament in Jordan,Moldova,Pakistan,1478,1017,5,0,4,-4,1482,1013,74,180,4,0,78,180,30,0,461
347,Aug 19 1992,Friendly in Bulgaria,Bulgaria,Mexico,1789,1802,1,1,-2,2,1787,1804,21,20,0,0,21,20,20,100,87
348,Aug 19 1992,Friendly in Czechoslovakia,Czechoslovakia,Austria,1855,1600,2,2,-8,8,1847,1608,15,53,0,0,15,53,20,100,355
349,Aug 20 1992,Friendly tournament in Jordan,Iraq,Congo,1669,1480,3,0,13,-13,1682,1467,35,86,2,-3,37,83,30,0,189
350,Aug 20 1992,Friendly tournament in Jordan,Jordan,Pakistan,1292,1013,2,0,5,-5,1297,1008,129,180,0,0,129,180,20,0,279
351,Aug 20 1992,Friendly tournament in Jordan,Moldova,Sudan,1482,1341,2,1,9,-9,1491,1332,76,116,1,-1,77,115,30,0,141
352,Aug 22 1992,Dynasty Cup in China,China,North Korea,1498,1541,2,2,-2,2,1496,1543,75,66,0,0,75,66,20,100,57
353,Aug 22 1992,Friendly tournament in Jordan,Congo,Ethiopia,1467,1432,3,0,24,-24,1491,1408,71,113,6,-10,77,103,30,0,35
354,Aug 22 1992,Dynasty Cup in China,Japan,South Korea,1368,1683,0,0,11,-11,1379,1672,106,43,1,-4,107,39,30,0,-315
355,Aug 22 1992,Friendly tournament in Jordan,Jordan,Moldova,1297,1491,1,0,19,-19,1316,1472,113,89,8,-6,121,83,30,100,-94
356,Aug 22 1992,Friendly tournament in Jordan,Sudan,Pakistan,1332,1008,4,0,8,-8,1340,1000,113,184,1,-2,114,182,30,0,324
357,Aug 23 1992,World Cup qualifier in Costa Rica,Costa Rica,Panama,1574,1319,5,1,9,-9,1583,1310,59,134,1,-8,60,126,40,100,355
358,Aug 23 1992,Friendly tournament in Uzbekistan,Uzbekistan,Kyrgyzstan,1682,1200,3,0,2,-2,1684,1198,35,151,0,0,35,151,20,0,482
359,Aug 24 1992,Dynasty Cup in China,China,Japan,1496,1379,0,2,-35,35,1461,1414,95,91,-10,8,85,99,30,100,217
360,Aug 24 1992,Dynasty Cup in China,North Korea,South Korea,1543,1672,1,1,5,-5,1548,1667,62,39,2,0,64,39,30,0,-129
361,Aug 26 1992,Dynasty Cup in China,China,South Korea,1461,1667,0,2,-16,16,1445,1683,97,35,-6,2,91,37,30,100,-106
362,Aug 26 1992,Friendly in Finland,Finland,Poland,1584,1787,0,0,3,-3,1587,1784,59,21,0,0,59,21,20,100,-103
363,Aug 26 1992,Friendly in France,France,Brazil,1939,1985,0,2,-17,17,1922,2002,10,0,-1,2,9,2,20,100,54
364,Aug 26 1992,Friendly in Hungary,Hungary,Ukraine,1696,1591,2,1,5,-5,1701,1586,33,64,0,-4,33,60,20,100,205
365,Aug 26 1992,Friendly tournament in Jordan,Iraq,Moldova,1682,1472,1,0,7,-7,1689,1465,31,84,3,-1,34,83,30,0,210
366,Aug 26 1992,Dynasty Cup in China,Japan,North Korea,1414,1548,4,1,36,-36,1450,1512,77,80,11,-8,88,72,30,0,-134
367,Aug 26 1992,Friendly tournament in Jordan,Jordan,Congo,1316,1491,2,1,18,-18,1334,1473,110,86,5,-5,115,81,30,100,-75
368,Aug 26 1992,World Cup qualifier in Latvia,Latvia,Denmark,1355,1953,0,0,18,-18,1373,1935,105,7,3,0,108,7,40,100,-498
369,Aug 26 1992,Friendly in Norway,Norway,Sweden,1726,1859,2,2,1,-1,1727,1858,28,14,0,0,28,14,20,100,-33
370,Aug 26 1992,Friendly in Romania,Romania,Mexico,1829,1804,2,0,10,-10,1839,1794,15,20,1,0,16,20,20,100,125
371,Aug 26 1992,Friendly in Turkey,Turkey,Bulgaria,1583,1787,3,2,13,-13,1596,1774,50,27,5,-3,55,24,20,100,-104
372,Aug 28 1992,Friendly tournament in Jordan,Jordan,Iraq,1334,1689,2,0,37,-37,1371,1652,105,50,5,-8,110,42,30,100,-255
373,Aug 28 1992,Friendly tournament in Jordan,Moldova,Congo,1465,1473,3,1,23,-23,1488,1450,71,93,6,-6,77,87,30,0,-8
374,Aug 29 1992,Dynasty Cup in China,China,North Korea,1445,1512,0,0,-1,1,1444,1513,91,70,0,1,91,71,20,100,33
375,Aug 29 1992,Dynasty Cup in China,Japan,South Korea,1450,1683,2,2,9,-9,1459,1674,81,38,3,-1,84,37,30,0,-233
376,Aug 29 1992,African Nations Cup qualifier in Kenya,Kenya,Zaire,1425,1551,1,3,-28,28,1397,1579,115,62,-10,0,105,62,40,100,-26
377,Aug 29 1992,African Nations Cup qualifier in Malawi,Malawi,Mali,1392,1421,1,1,-4,4,1388,1425,107,96,0,0,107,96,40,100,71
378,Aug 29 1992,African Nations Cup qualifier in Nigeria,Nigeria,Uganda,1623,1515,2,0,14,-14,1637,1501,42,75,4,-2,46,73,40,100,208
379,Aug 29 1992,African Nations Cup qualifier in Sierra Leone,Sierra Leone,Algeria,1411,1686,1,0,29,-29,1440,1657,83,48,9,-7,92,41,40,100,-175
380,Aug 30 1992,African Nations Cup qualifier in Cameroon,Cameroon,Benin,1660,1189,2,0,2,-2,1662,1187,39,157,0,-2,39,155,20,0,471
381,Aug 30 1992,African Nations Cup qualifier in Congo,Congo,Chad,1450,1239,2,0,9,-9,1459,1230,80,144,4,-2,84,142,40,100,311
382,Aug 30 1992,African Nations Cup qualifier in Ethiopia,Ethiopia,Sudan,1408,1340,3,0,19,-19,1427,1321,89,125,7,-5,96,120,40,100,168
383,Aug 30 1992,African Nations Cup qualifier in Ghana,Ghana,Burkina Faso,1625,1421,3,0,10,-10,1635,1411,47,103,1,-3,48,100,40,100,304
384,Aug 30 1992,African Nations Cup qualifier in Guinea,Guinea,Burundi,1419,1312,2,2,-11,11,1408,1323,108,115,-5,4,103,119,40,100,207
385,Aug 30 1992,African Nations Cup qualifier in Liberia,Liberia,Tanzania,1412,1319,1,1,-10,10,1402,1329,108,113,-4,3,104,116,40,100,193
386,Aug 30 1992,African Nations Cup qualifier in Mauritius,Mauritius,Zimbabwe,1248,1482,0,1,-13,13,1235,1495,143,72,-3,3,140,75,40,100,-134
387,Aug 30 1992,African Nations Cup qualifier in Mozambique,Mozambique,Lesotho,1333,1203,3,0,15,-15,1348,1188,112,159,2,-5,114,154,40,100,230
388,Aug 30 1992,African Nations Cup qualifier in Niger,Niger,Gabon,1393,1408,1,3,-37,37,1356,1445,118,79,-6,12,112,91,40,100,85
389,Aug 30 1992,African Nations Cup qualifier in Senegal,Senegal,Guinea-Bissau,1547,1327,3,0,10,-10,1557,1317,61,126,2,-4,63,122,40,100,320
390,Aug 30 1992,African Nations Cup qualifier in South Africa,South Africa,Zambia,1710,1612,0,1,-30,30,1680,1642,38,38,-3,7,35,45,40,100,198
391,Aug 30 1992,World Cup qualifier in St Vincent & Grenadines,St Vincent & Grenadines,Suriname,1312,1350,2,1,16,-16,1328,1334,111,117,6,-2,117,115,40,100,62
392,Sep 2 1992,Friendly in Austria,Austria,Portugal,1608,1781,1,1,2,-2,1610,1779,53,22,0,0,53,22,20,100,-73
393,Sep 2 1992,World Cup qualifier in Czechoslovakia,Czechoslovakia,Belgium,1847,1817,1,2,-27,27,1820,1844,21,12,-3,3,18,15,40,100,130
394,Sep 2 1992,Friendly in Greece,Greece,Cyprus,1676,1290,2,3,-19,19,1657,1309,44,124,-4,3,40,127,20,100,486
395,Sep 2 1992,Friendly in Lithuania,Lithuania,Georgia,1255,1628,1,0,17,-17,1272,1611,129,54,2,-2,131,52,20,100,-273
396,Sep 3 1992,Friendly in Canada,Canada,United States,1539,1664,0,2,-14,14,1525,1678,72,35,-2,1,70,36,20,100,-25
397,Sep 4 1992,World Cup qualifier in the Solomon Islands,Solomon Islands,Australia,1237,1713,1,2,-4,4,1233,1717,141,29,-1,1,140,30,40,100,-376
398,Sep 9 1992,World Cup qualifier in Bulgaria,Bulgaria,France,1774,1922,2,0,34,-34,1808,1888,14,9,5,0,19,9,40,100,-48
399,Sep 9 1992,Friendly in Denmark,Denmark,Germany,1935,1991,1,2,-11,11,1924,2002,9,-2,-1,3,8,1,20,100,44
400,Sep 9 1992,World Cup qualifier in Finland,Finland,Sweden,1587,1858,0,1,-11,11,1576,1869,65,10,-3,2,62,12,40,100,-171
401,Sep 9 1992,World Cup qualifier in Ireland,Ireland,Latvia,1877,1373,4,0,2,-2,1879,1371,11,109,0,-1,11,108,20,0,504
402,Sep 9 1992,World Cup qualifier in Luxembourg,Luxembourg,Hungary,1170,1701,0,3,-5,5,1165,1706,163,32,-2,0,161,32,40,100,-431
403,Sep 9 1992,Friendly in the Netherlands,Netherlands,Italy,2013,1982,2,3,-14,14,1999,1996,5,3,-2,1,3,4,20,100,131
404,Sep 9 1992,World Cup qualifier in Norway,Norway,San Marino,1727,999,10,0,1,-1,1728,998,28,184,0,0,28,184,20,0,728
405,Sep 9 1992,World Cup qualifier in Northern Ireland,Northern Ireland,Albania,1647,1449,3,0,11,-11,1658,1438,37,97,3,-4,40,93,40,100,298
406,Sep 9 1992,Friendly in Poland,Poland,Israel,1784,1625,1,1,-6,6,1778,1631,27,50,-3,0,24,50,20,100,259
407,Sep 9 1992,Friendly in Spain,Spain,England,1838,1965,1,0,11,-11,1849,1954,13,6,2,0,15,6,20,100,-27
408,Sep 9 1992,World Cup qualifier in Switzerland,Switzerland,Scotland,1775,1816,3,1,25,-25,1800,1791,17,25,3,-3,20,22,30,0,-41
409,Sep 9 1992,Pan Arab Games in Syria,Syria,Saudi Arabia,1455,1598,1,1,2,-2,1457,1596,86,54,0,0,86,54,30,100,-43
410,Sep 9 1992,World Cup qualifier in Wales,Wales,Faroe Islands,1773,1230,6,0,2,-2,1775,1228,24,148,1,-3,25,145,20,0,543
411,Sep 10 1992,Pan Arab Games in Syria,Kuwait,Jordan,1489,1371,4,1,24,-24,1513,1347,65,120,6,-6,71,114,40,0,118
412,Sep 11 1992,Pan Arab Games in Syria,Syria,Palestine,1457,1227,0,0,-15,15,1442,1242,96,130,-5,8,91,138,40,100,330
413,Sep 11 1992,World Cup qualifier in Tahiti,Tahiti,Australia,1479,1717,0,3,-22,22,1457,1739,90,26,-5,2,85,28,40,100,-138
414,Sep 12 1992,World Cup qualifier in Fiji,Fiji,Vanuatu,1449,1004,3,0,3,-3,1452,1001,86,182,1,0,87,182,20,0,445
415,Sep 13 1992,Friendly in El Salvador,El Salvador,Honduras,1433,1683,3,1,21,-21,1454,1662,77,40,9,-3,86,37,20,100,-150
416,Sep 13 1992,Pan Arab Games in Syria,Saudi Arabia,Palestine,1596,1242,2,1,5,-5,1601,1237,54,140,0,-1,54,139,40,0,354
417,Sep 14 1992,Friendly tournament in Turkmenistan,Turkmenistan,Kazakhstan,1480,1616,1,1,2,-2,1482,1614,79,51,0,0,79,51,30,100,-36
418,Sep 15 1992,Pan Arab Games in Syria,Saudi Arabia,Kuwait,1601,1513,2,0,23,-23,1624,1490,48,83,3,-6,51,77,40,0,88
419,Sep 17 1992,Friendly in Georgia,Georgia,Azerbaijan,1611,1535,6,3,9,-9,1620,1526,51,70,1,-1,52,69,20,100,176
420,Sep 17 1992,Pan Arab Games in Syria,Syria,Kuwait,1442,1490,1,2,-23,23,1419,1513,104,65,-6,6,98,71,40,100,52
421,Sep 18 1992,Friendly in Honduras,Honduras,El Salvador,1662,1454,1,1,-7,7,1655,1461,47,80,-5,3,42,83,20,100,308
422,Sep 19 1992,World Cup qualifier in Fiji,Fiji,New Zealand,1452,1541,0,0,-1,1,1451,1542,88,66,0,0,88,66,40,100,11
423,Sep 20 1992,World Cup qualifier in Australia,Australia,Tahiti,1739,1457,2,0,6,-6,1745,1451,28,88,0,-1,28,87,40,100,382
424,Sep 22 1992,Friendly in Honduras,Honduras,Jamaica,1655,1453,5,1,6,-6,1661,1447,34,92,4,-3,38,89,20,100,302
425,Sep 23 1992,Friendly in Brazil,Brazil,Costa Rica,2002,1583,4,2,1,-1,2003,1582,1,60,0,0,1,60,20,100,519
426,Sep 23 1992,World Cup qualifier in Czechoslovakia,Czechoslovakia,Faroe Islands,1820,1228,4,0,1,-1,1821,1227,18,146,0,0,18,146,20,0,592
427,Sep 23 1992,Friendly in Hungary,Hungary,Israel,1706,1631,0,0,-5,5,1701,1636,32,46,0,2,32,48,20,100,175
428,Sep 23 1992,World Cup qualifier in Latvia,Latvia,Spain,1371,1849,0,0,16,-16,1387,1833,106,19,1,-2,107,17,40,100,-378
429,Sep 23 1992,World Cup qualifier in Lithuania,Lithuania,Denmark,1272,1924,0,0,18,-18,1290,1906,131,8,0,0,131,8,40,100,-552
430,Sep 23 1992,World Cup qualifier in Norway,Norway,Netherlands,1728,1999,2,1,29,-29,1757,1970,27,7,1,-2,28,5,40,100,-171
431,Sep 23 1992,World Cup qualifier in Poland,Poland,Turkey,1778,1596,1,0,7,-7,1785,1589,22,57,1,-1,23,56,40,100,282
432,Sep 23 1992,Friendly in Tunisia,Tunisia,Algeria,1548,1657,1,1,0,0,1548,1657,65,41,0,0,65,41,20,100,-9
433,Sep 23 1992,Lipton Cup in Uruguay,Uruguay,Argentina,1864,1994,0,0,1,-1,1865,1993,13,3,0,1,13,4,20,100,-30
434,Sep 24 1992,Friendly in Honduras,Honduras,Jamaica,1661,1447,7,0,6,-6,1667,1441,36,93,1,-2,37,91,20,100,314
435,Sep 26 1992,World Cup qualifier in Australia,Australia,Solomon Islands,1745,1233,6,1,2,-2,1747,1231,29,143,0,-1,29,142,20,0,512
436,Sep 26 1992,Friendly tournament in Kyrgyzstan,Kyrgyzstan,Kazakhstan,1198,1614,1,1,11,-11,1209,1603,148,55,1,-1,149,54,30,100,-316
437,Sep 26 1992,World Cup qualifier in Vanuatu,Vanuatu,Fiji,1001,1451,0,3,-8,8,993,1459,186,82,-2,2,184,84,40,100,-350
438,Sep 27 1992,Friendly tournament in St Vincent & Grenadines,St Vincent & Grenadines,Jamaica,1328,1441,0,1,-14,14,1314,1455,129,83,-6,4,123,87,30,100,-13
439,Sep 30 1992,Friendly in Botswana,Botswana,Kenya,1078,1397,1,3,-7,7,1071,1404,177,103,-1,1,176,104,20,100,-219
440,Oct 2 1992,Friendly in Iran,Iran,Cameroon,1645,1662,1,1,-2,2,1643,1664,44,38,0,0,44,38,20,100,83
441,Oct 3 1992,Friendly in Botswana,Botswana,Kenya,1071,1404,0,1,-4,4,1067,1408,178,102,-1,1,177,103,20,100,-233
442,Oct 3 1992,Friendly tournament in Kyrgyzstan,Kyrgyzstan,Uzbekistan,1209,1684,2,6,-6,6,1203,1690,149,33,0,0,149,33,30,100,-375
443,Oct 3 1992,African Nations Cup qualifier in Togo,Togo,Algeria,1372,1657,0,0,10,-10,1382,1647,108,45,0,-2,108,43,30,0,-285
444,Oct 4 1992,Friendly in Gabon,Gabon,Chad,1445,1230,1,0,3,-3,1448,1227,92,147,-1,-2,91,145,20,100,315
445,Oct 4 1992,African Nations Cup qualifier in Guinea-Bissau,Guinea-Bissau,Sierra Leone,1317,1440,0,3,-33,33,1284,1473,141,70,-10,11,131,81,40,100,-23
446,Oct 4 1992,Friendly in Iran,Iran,Cameroon,1643,1664,0,0,-2,2,1641,1666,48,38,-2,0,46,38,20,100,79
447,Oct 4 1992,Friendly tournament in Jamaica,Jamaica,St Vincent & Grenadines,1455,1314,3,3,-9,9,1446,1323,97,113,-5,5,92,118,30,100,241
448,Oct 4 1992,African Nations Cup qualifier in Mali,Mali,Morocco,1425,1596,2,1,24,-24,1449,1572,83,69,7,-7,90,62,40,100,-71
449,Oct 6 1992,Friendly in Saudi Arabia,Saudi Arabia,Cameroon,1624,1666,2,1,8,-8,1632,1658,51,40,0,-1,51,39,20,100,58
450,Oct 7 1992,Friendly in Cyprus,Cyprus,Malta,1309,1426,3,0,18,-18,1327,1408,110,107,8,-5,118,102,20,100,-17
451,Oct 7 1992,World Cup qualifier in Iceland,Iceland,Greece,1589,1657,0,1,-22,22,1567,1679,69,29,-7,6,62,35,40,100,32
452,Oct 7 1992,Friendly in the United States,Mexico,El Salvador,1794,1461,2,0,4,-4,1798,1457,19,90,1,-3,20,87,20,0,333
453,Oct 7 1992,World Cup qualifier in San Marino,San Marino,Norway,998,1757,0,2,-1,1,997,1758,183,28,0,0,183,28,20,100,-659
454,Oct 7 1992,World Cup qualifier in Sweden,Sweden,Bulgaria,1869,1808,2,0,17,-17,1886,1791,8,23,2,-2,10,21,40,100,161
455,Oct 9 1992,World Cup qualifier in Algeria,Algeria,Burundi,1647,1323,3,1,5,-5,1652,1318,41,125,1,-3,42,122,40,100,424
456,Oct 9 1992,World Cup qualifier in Tahiti,Tahiti,Solomon Islands,1451,1231,4,2,8,-8,1459,1223,80,150,4,-4,84,146,40,100,320
457,Oct 9 1992,Friendly in the United States,United States,Canada,1678,1525,0,0,-6,6,1672,1531,38,68,-1,1,37,69,20,100,253
458,Oct 9 1992,World Cup qualifier in Zimbabwe,Zimbabwe,Togo,1495,1382,1,0,9,-9,1504,1373,70,108,3,0,73,108,40,100,213
459,Oct 10 1992,World Cup qualifier in Nigeria,Nigeria,South Africa,1637,1680,4,0,31,-31,1668,1649,27,54,10,-10,37,44,40,100,57
460,Oct 11 1992,World Cup qualifier in Egypt,Egypt,Angola,1634,1410,1,0,5,-5,1639,1405,46,107,2,-3,48,104,40,100,324
461,Oct 11 1992,World Cup qualifier in Gabon,Gabon,Mozambique,1448,1348,3,1,14,-14,1462,1334,75,115,8,-1,83,114,40,100,200
462,Oct 11 1992,World Cup qualifier in Ivory Coast,Ivory Coast,Botswana,1724,1067,6,0,1,-1,1725,1066,30,177,0,0,30,177,20,0,657
463,Oct 11 1992,World Cup qualifier in Madagascar,Madagascar,Namibia,1467,1167,3,0,6,-6,1473,1161,80,162,1,-1,81,161,40,100,400
464,Oct 11 1992,World Cup qualifier in Morocco,Morocco,Ethiopia,1572,1427,5,0,16,-16,1588,1411,53,100,4,-2,57,98,40,100,245
465,Oct 11 1992,Friendly in Qatar,Qatar,Hungary,1492,1701,1,4,-12,12,1480,1713,81,32,-2,0,79,32,20,100,-109
466,Oct 11 1992,World Cup qualifier in Tunisia,Tunisia,Benin,1548,1187,5,1,5,-5,1553,1182,63,155,1,0,64,155,40,100,461
467,Oct 11 1992,World Cup qualifier in Zaire,Zaire,Liberia,1579,1402,4,2,10,-10,1589,1392,51,105,4,0,55,105,40,100,277
468,Oct 11 1992,World Cup qualifier in Zambia,Zambia,Tanzania,1642,1329,2,0,5,-5,1647,1324,45,120,0,-2,45,118,40,100,413
469,Oct 13 1992,Friendly in Qatar,Qatar,Hungary,1480,1713,1,1,4,-4,1484,1709,77,32,1,0,78,32,20,100,-133
470,Oct 14 1992,Friendly in Armenia,Armenia,Moldova,1242,1488,0,0,4,-4,1246,1484,136,79,1,-1,137,78,20,100,-146
471,Oct 14 1992,World Cup qualifier in Belgium,Belgium,Romania,1844,1839,1,0,14,-14,1858,1825,15,18,0,-1,15,17,40,100,105
472,Oct 14 1992,World Cup qualifier in Cyprus,Cyprus,Wales,1327,1775,0,1,-5,5,1322,1780,121,25,-2,0,119,25,40,100,-348
473,Oct 14 1992,World Cup qualifier in Denmark,Denmark,Ireland,1906,1879,0,0,-7,7,1899,1886,8,8,0,2,8,10,40,100,127
474,Oct 14 1992,World Cup qualifier in England,England,Norway,1954,1758,1,1,-14,14,1940,1772,6,26,0,1,6,27,40,100,296
475,Oct 14 1992,World Cup qualifier in France,France,Austria,1888,1610,2,0,6,-6,1894,1604,9,55,0,-1,9,54,40,100,378
476,Oct 14 1992,Friendly in Germany,Germany,Mexico,2002,1798,1,1,-7,7,1995,1805,2,20,0,0,2,20,20,100,304
477,Oct 14 1992,World Cup qualifier in Italy,Italy,Switzerland,1996,1800,2,2,-14,14,1982,1814,5,19,-1,0,4,19,40,100,296
478,Oct 14 1992,Friendly in Lithuania,Lithuania,Slovakia,1290,1660,0,1,-3,3,1287,1663,130,39,0,0,130,39,20,100,-270
479,Oct 14 1992,World Cup qualifier in the Netherlands,Netherlands,Poland,1970,1785,2,2,-14,14,1956,1799,5,19,0,2,5,21,40,100,285
480,Oct 14 1992,World Cup qualifier in Northern Ireland,Northern Ireland,Spain,1658,1833,0,0,4,-4,1662,1829,40,15,0,1,40,16,40,100,-75
481,Oct 14 1992,World Cup qualifier in Russia,Russia,Iceland,1880,1567,1,0,3,-3,1883,1564,13,62,-1,0,12,62,20,0,313
482,Oct 14 1992,World Cup qualifier in Scotland,Scotland,Portugal,1791,1779,0,0,-6,6,1785,1785,25,22,-2,1,23,23,40,100,112
483,Oct 14 1992,Friendly tournament in Turkmenistan,Turkmenistan,Kyrgyzstan,1482,1203,4,0,6,-6,1488,1197,75,151,2,-1,77,150,20,0,279
484,Oct 14 1992,Friendly tournament in Uzbekistan,Uzbekistan,Kazakhstan,1690,1603,1,1,-7,7,1683,1610,33,52,0,1,33,53,30,100,187
485,Oct 15 1992,Intercontinental Champ in Saudi Arabia,Saudi Arabia,United States,1632,1672,3,0,36,-36,1668,1636,21,62,15,-13,36,49,50,100,60
486,Oct 16 1992,Intercontinental Champ in Saudi Arabia,Argentina,Ivory Coast,1993,1725,4,0,17,-17,2010,1708,-1,34,2,-2,1,32,50,0,268
487,Oct 18 1992,World Cup qualifier in Bermuda,Bermuda,El Salvador,1411,1457,1,0,17,-17,1428,1440,94,97,2,-4,96,93,30,0,-46
488,Oct 18 1992,World Cup qualifier in Cameroon,Cameroon,Swaziland,1658,1189,5,0,3,-3,1661,1186,41,156,0,-2,41,154,20,0,469
489,Oct 18 1992,World Cup qualifier in Jamaica,Jamaica,Canada,1446,1531,1,1,-1,1,1445,1532,90,67,1,1,91,68,30,100,15
490,Oct 18 1992,Friendly in Kuwait,Kuwait,Iran,1513,1641,1,1,1,-1,1514,1640,71,47,0,0,71,47,20,100,-28
491,Oct 18 1992,Friendly in Niger,Niger,Mali,1356,1449,0,2,-15,15,1341,1464,115,75,-2,8,113,83,20,100,7
492,Oct 19 1992,Intercontinental Champ in Saudi Arabia,United States,Ivory Coast,1636,1708,5,2,53,-53,1689,1655,15,52,17,-10,32,42,50,0,-72
493,Oct 20 1992,Intercontinental Champ in Saudi Arabia,Saudi Arabia,Argentina,1668,2010,1,3,-15,15,1653,2025,48,1,-6,0,42,1,50,100,-242
494,Oct 21 1992,Friendly in South Korea,South Korea,United Arab Emirates,1674,1475,0,0,-7,7,1667,1482,37,80,-1,0,36,80,20,100,299
495,Oct 22 1992,Friendly in Croatia,Croatia,Mexico,1861,1805,3,0,10,-10,1871,1795,12,22,1,-1,13,21,20,100,156
496,Oct 22 1992,Friendly in Kuwait,Kuwait,Oman,1514,1081,4,0,2,-2,1516,1079,71,174,0,0,71,174,20,100,533
497,Oct 24 1992,Friendly in South Korea,South Korea,United Arab Emirates,1667,1482,1,1,-7,7,1660,1489,44,74,-4,3,40,77,20,100,285
498,Oct 25 1992,World Cup qualifier in Benin,Benin,Morocco,1182,1588,0,1,-6,6,1176,1594,159,53,-2,2,157,55,40,100,-306
499,Oct 25 1992,World Cup qualifier in Bermuda,Bermuda,Jamaica,1428,1445,1,1,-5,5,1423,1450,96,91,0,0,96,91,40,100,83
500,Oct 25 1992,World Cup qualifier in Burundi,Burundi,Ghana,1318,1635,1,0,31,-31,1349,1604,104,55,9,-2,113,53,40,100,-217
501,Oct 25 1992,World Cup qualifier in El Salvador,El Salvador,Canada,1440,1532,1,1,0,0,1440,1532,93,68,0,0,93,68,20,100,8
502,Oct 25 1992,World Cup qualifier in Ethiopia,Ethiopia,Tunisia,1411,1553,0,0,2,-2,1413,1551,99,64,0,0,99,64,30,100,-42
503,Oct 25 1992,Friendly tournament in Kazakhstan,Kazakhstan,Kyrgyzstan,1610,1197,2,0,2,-2,1612,1195,51,154,1,-2,52,152,30,100,513
504,Oct 25 1992,World Cup qualifier in Malta,Malta,Estonia,1408,1195,0,0,-14,14,1394,1209,107,149,-3,1,104,150,40,100,313
505,Oct 25 1992,World Cup qualifier in Mozambique,Mozambique,Senegal,1334,1557,0,1,-13,13,1321,1570,126,59,-6,2,120,61,40,100,-123
506,Oct 25 1992,World Cup qualifier in Namibia,Namibia,Zambia,1161,1647,0,4,-7,7,1154,1654,163,40,-1,3,162,43,40,100,-386
507,Oct 25 1992,World Cup qualifier in Niger,Niger,Ivory Coast,1341,1655,0,0,11,-11,1352,1644,109,53,2,-6,111,47,30,0,-314
508,Oct 25 1992,World Cup qualifier in South Africa,South Africa,Congo,1649,1459,1,0,6,-6,1655,1453,39,92,3,-3,42,89,40,100,290
509,Oct 25 1992,World Cup qualifier in Swaziland,Swaziland,Zaire,1186,1589,1,0,34,-34,1220,1555,142,71,6,-8,148,63,40,100,-303
510,Oct 25 1992,World Cup qualifier in Tanzania,Tanzania,Madagascar,1324,1473,0,0,3,-3,1327,1470,117,83,0,-1,117,82,40,100,-49
511,Oct 25 1992,World Cup qualifier in Togo,Togo,Egypt,1373,1639,1,4,-19,19,1354,1658,112,33,-2,8,110,41,40,100,-166
512,Oct 25 1992,Friendly tournament in Turkmenistan,Turkmenistan,Uzbekistan,1488,1683,1,0,19,-19,1507,1664,68,39,5,-3,73,36,30,100,-95
513,Oct 28 1992,World Cup qualifier in Austria,Austria,Israel,1604,1636,5,2,28,-28,1632,1608,47,56,3,-3,50,53,40,100,68
514,Oct 28 1992,Friendly in Belarus,Belarus,Ukraine,1400,1586,1,1,2,-2,1402,1584,104,58,0,0,104,58,20,100,-86
515,Oct 28 1992,World Cup qualifier in Lithuania,Lithuania,Latvia,1287,1387,1,1,0,0,1287,1387,132,109,-1,-1,131,108,20,100,0
516,Oct 28 1992,World Cup qualifier in Russia,Russia,Luxembourg,1883,1165,2,0,1,-1,1884,1164,12,162,0,-1,12,161,30,0,718
517,Oct 28 1992,World Cup qualifier in Turkey,Turkey,San Marino,1589,997,4,1,1,-1,1590,996,56,185,0,-1,56,184,20,0,592
518,Oct 29 1992,Asian Cup in Japan,China,Saudi Arabia,1444,1653,1,1,13,-13,1457,1640,86,52,3,-4,89,48,50,0,-209
519,Oct 29 1992,Asian Cup in Japan,Qatar,Thailand,1484,1366,1,1,-8,8,1476,1374,81,109,-1,0,80,109,30,100,218
520,Oct 30 1992,Asian Cup in Japan,Iran,North Korea,1640,1513,2,0,24,-24,1664,1489,24,84,12,-6,36,78,50,0,127
521,Oct 30 1992,Asian Cup in Japan,Japan,United Arab Emirates,1459,1489,0,0,-5,5,1454,1494,92,76,-3,1,89,77,50,100,70
522,Oct 31 1992,Asian Cup in Japan,China,Thailand,1457,1374,0,0,-6,6,1451,1380,92,109,-2,0,90,109,50,0,83
523,Oct 31 1992,Asian Cup in Japan,Qatar,Saudi Arabia,1476,1640,1,1,11,-11,1487,1629,78,51,1,-1,79,50,50,0,-164
524,Nov 1 1992,World Cup qualifier in Canada,Canada,Jamaica,1532,1450,1,0,10,-10,1542,1440,64,94,2,-1,66,93,40,100,182
525,Nov 1 1992,World Cup qualifier in El Salvador,El Salvador,Bermuda,1440,1423,4,1,24,-24,1464,1399,73,112,10,-8,83,104,40,100,117
526,Nov 1 1992,Asian Cup in Japan,Iran,United Arab Emirates,1664,1494,0,0,-11,11,1653,1505,52,69,-8,4,44,73,50,0,170
527,Nov 1 1992,Asian Cup in Japan,Japan,North Korea,1454,1489,1,1,-5,5,1449,1494,96,78,-4,0,92,78,50,100,65
528,Nov 2 1992,Asian Cup in Japan,China,Qatar,1451,1487,2,1,28,-28,1479,1459,70,95,10,-8,80,87,50,0,-36
529,Nov 2 1992,Friendly in Egypt,Egypt,Kuwait,1658,1516,1,1,-6,6,1652,1522,47,71,-3,0,44,71,20,100,242
530,Nov 2 1992,Asian Cup in Japan,Saudi Arabia,Thailand,1629,1380,4,0,18,-18,1647,1362,44,109,3,0,47,109,50,0,249
531,Nov 3 1992,Asian Cup in Japan,Japan,Iran,1449,1653,1,0,32,-32,1481,1621,66,57,13,-7,79,50,50,100,-104
532,Nov 3 1992,Asian Cup in Japan,United Arab Emirates,North Korea,1505,1494,2,1,24,-24,1529,1470,67,86,3,-4,70,82,50,0,11
533,Nov 6 1992,Asian Cup in Japan,Japan,China,1481,1479,3,2,18,-18,1499,1461,77,94,1,-7,78,87,50,100,102
534,Nov 6 1992,Asian Cup in Japan,Saudi Arabia,United Arab Emirates,1647,1529,2,0,25,-25,1672,1504,22,76,12,-3,34,73,50,0,118
535,Nov 7 1992,Friendly in Tunisia,Tunisia,Finland,1551,1576,1,1,-2,2,1549,1578,64,60,0,0,64,60,20,100,75
536,Nov 7 1992,Friendly in Zimbabwe,Zimbabwe,Malawi,1504,1388,0,1,-16,16,1488,1404,83,99,-5,4,78,103,20,100,216
537,Nov 8 1992,World Cup qualifier in Canada,Canada,El Salvador,1542,1464,2,3,-29,29,1513,1493,78,75,-6,4,72,79,40,100,178
538,Nov 8 1992,Asian Cup in Japan,China,United Arab Emirates,1461,1504,1,1,3,-3,1464,1501,81,79,3,-3,84,76,50,0,-43
539,Nov 8 1992,World Cup qualifier in Costa Rica,Costa Rica,Honduras,1582,1667,2,3,-21,21,1561,1688,63,30,-2,3,61,33,40,100,15
540,Nov 8 1992,World Cup qualifier in Jamaica,Jamaica,Bermuda,1440,1399,3,2,12,-12,1452,1387,91,109,1,-2,92,107,40,100,141
541,Nov 8 1992,Asian Cup in Japan,Japan,Saudi Arabia,1499,1672,1,0,30,-30,1529,1642,61,60,8,-13,69,47,50,100,-73
542,Nov 8 1992,African Nations Cup qualifier in Morocco,Morocco,Egypt,1594,1652,0,0,-2,2,1592,1654,55,40,0,2,55,42,30,100,42
543,Nov 8 1992,African Nations Cup qualifier in Guinea,Sierra Leone,Senegal,1473,1570,2,0,38,-38,1511,1532,66,73,7,-6,73,67,40,0,-97
544,Nov 8 1992,World Cup qualifier in St Vincent & Grenadines,St Vincent & Grenadines,Mexico,1323,1795,0,4,-8,8,1315,1803,129,19,-5,1,124,20,40,100,-372
545,Nov 8 1992,African Nations Cup qualifier in Togo,Togo,Guinea-Bissau,1354,1284,0,0,-9,9,1345,1293,119,130,-4,1,115,131,40,100,170
546,Nov 9 1992,Friendly in Zimbabwe,Zimbabwe,Malawi,1488,1404,4,1,9,-9,1497,1395,78,105,1,-1,79,104,20,100,184
547,Nov 11 1992,World Cup qualifier in Albania,Albania,Latvia,1438,1387,1,1,-8,8,1430,1395,96,101,-1,3,95,104,40,100,151
548,Nov 11 1992,World Cup qualifier in Greece,Greece,Hungary,1679,1709,0,0,-4,4,1675,1713,34,31,0,0,34,31,40,100,70
549,Nov 11 1992,World Cup qualifier in Israel,Israel,Sweden,1608,1886,1,3,-16,16,1592,1902,55,6,-1,2,54,8,40,100,-178
550,Nov 11 1992,Friendly in France,Portugal,Bulgaria,1785,1791,2,1,10,-10,1795,1781,21,26,1,-2,22,24,20,0,-6
551,Nov 14 1992,World Cup qualifier in France,France,Finland,1894,1578,2,1,3,-3,1897,1575,10,59,0,0,10,59,20,0,316
552,Nov 14 1992,World Cup qualifier in Romania,Romania,Czechoslovakia,1825,1821,1,1,-6,6,1819,1827,19,16,-1,1,18,17,40,100,104
553,Nov 15 1992,World Cup qualifier in Canada,Canada,Bermuda,1513,1387,4,2,13,-13,1526,1374,68,108,2,0,70,108,40,100,226
554,Nov 15 1992,CECAFA Cup in Tanzania,Ethiopia,Zanzibar,1413,1124,3,0,11,-11,1424,1113,94,165,2,0,96,165,40,0,289
555,Nov 15 1992,CECAFA Cup in Tanzania,Kenya,Uganda,1408,1501,1,1,5,-5,1413,1496,98,82,1,-3,99,79,40,0,-93
556,Nov 15 1992,World Cup qualifier in Mexico,Mexico,Honduras,1803,1688,2,0,13,-13,1816,1675,18,33,1,0,19,33,40,100,215
557,Nov 15 1992,Friendly in Niger,Niger,Mali,1352,1464,0,1,-10,10,1342,1474,119,80,-4,2,115,82,20,100,-12
558,Nov 15 1992,World Cup qualifier in St Vincent & Grenadines,St Vincent & Grenadines,Costa Rica,1315,1561,0,1,-12,12,1303,1573,130,59,-3,1,127,60,40,100,-146
559,Nov 16 1992,CECAFA Cup in Tanzania,Tanzania,Malawi,1327,1395,1,1,-2,2,1325,1397,118,104,0,0,118,104,40,100,32
560,Nov 17 1992,Friendly in the United Arab Emirates,United Arab Emirates,Senegal,1501,1532,1,1,-2,2,1499,1534,78,67,-1,0,77,67,20,100,69
561,Nov 17 1992,CECAFA Cup in Tanzania,Zambia,Ethiopia,1654,1424,3,2,8,-8,1662,1416,34,98,4,-1,38,97,40,0,230
562,Nov 18 1992,World Cup qualifier in Belgium,Belgium,Wales,1858,1780,2,0,16,-16,1874,1764,11,31,2,-3,13,28,40,100,178
563,Nov 18 1992,Friendly in Cyprus,Cyprus,Slovenia,1322,1588,1,1,4,-4,1326,1584,117,57,1,0,118,57,20,100,-166
564,Nov 18 1992,World Cup qualifier in England,England,Turkey,1940,1590,4,0,5,-5,1945,1585,6,56,0,0,6,56,40,100,450
565,Nov 18 1992,Friendly in Germany,Germany,Austria,1995,1632,0,0,-9,9,1986,1641,3,49,0,0,3,49,20,100,463
566,Nov 18 1992,CECAFA Cup in Tanzania,Kenya,Seychelles,1413,987,2,1,3,-3,1416,984,95,188,2,-1,97,187,40,0,426
567,Nov 18 1992,World Cup qualifier in Northern Ireland,Northern Ireland,Denmark,1662,1899,0,1,-12,12,1650,1911,52,7,-7,1,45,8,40,100,-137
568,Nov 18 1992,Friendly in Poland,Poland,Latvia,1799,1395,1,0,1,-1,1800,1394,21,105,0,0,21,105,20,100,504
569,Nov 18 1992,World Cup qualifier in Scotland,Scotland,Italy,1785,1982,0,0,5,-5,1790,1977,23,4,0,0,23,4,20,0,-197
570,Nov 18 1992,World Cup qualifier in Spain,Spain,Ireland,1829,1886,0,0,-2,2,1827,1888,16,11,0,0,16,11,30,100,43
571,Nov 18 1992,World Cup qualifier in Switzerland,Switzerland,Malta,1814,1394,3,0,3,-3,1817,1391,18,108,1,-1,19,107,20,0,420
572,Nov 18 1992,CECAFA Cup in Tanzania,Tanzania,Zanzibar,1325,1113,0,1,-34,34,1291,1147,144,163,-13,1,131,164,40,100,312
573,Nov 19 1992,CECAFA Cup in Tanzania,Malawi,Zambia,1397,1662,1,0,33,-33,1430,1629,86,60,9,-11,95,49,40,0,-265
574,Nov 19 1992,Friendly in the United Arab Emirates,United Arab Emirates,Senegal,1499,1534,2,2,-2,2,1497,1536,77,67,0,0,77,67,20,100,65
575,Nov 20 1992,Friendly in Egypt,Egypt,Kuwait,1654,1522,1,1,-6,6,1648,1528,47,68,-3,2,44,70,20,100,232
576,Nov 20 1992,CECAFA Cup in Tanzania,Tanzania,Ethiopia,1291,1416,2,1,21,-21,1312,1395,117,110,7,-6,124,104,40,100,-25
577,Nov 21 1992,CECAFA Cup in Tanzania,Uganda,Seychelles,1496,984,5,2,3,-3,1499,981,75,187,2,0,77,187,30,0,512
578,Nov 21 1992,CECAFA Cup in Tanzania,Zambia,Zanzibar,1629,1147,8,0,6,-6,1635,1141,49,164,0,0,49,164,40,0,482
579,Nov 22 1992,World Cup qualifier in Jamaica,Jamaica,El Salvador,1452,1493,0,2,-35,35,1417,1528,102,60,-5,10,97,70,40,100,59
580,Nov 22 1992,CECAFA Cup in Tanzania,Malawi,Ethiopia,1430,1395,2,1,18,-18,1448,1377,91,110,2,-3,93,107,40,0,35
581,Nov 22 1992,World Cup qualifier in Mexico,Mexico,Costa Rica,1816,1573,4,0,9,-9,1825,1564,16,60,2,0,18,60,40,100,343
582,Nov 22 1992,World Cup qualifier in St Vincent & Grenadines,St Vincent & Grenadines,Honduras,1303,1675,0,4,-13,13,1290,1688,135,33,-4,0,131,33,40,100,-272
583,Nov 23 1992,CECAFA Cup in Tanzania,Tanzania,Zambia,1312,1635,1,2,-9,9,1303,1644,128,41,-2,4,126,45,40,100,-223
584,Nov 24 1992,Friendly in Bahrain,Algeria,United Arab Emirates,1652,1497,0,0,-4,4,1648,1501,45,75,-2,2,43,77,20,0,155
585,Nov 24 1992,CECAFA Cup in Tanzania,Malawi,Zanzibar,1448,1141,3,1,9,-9,1457,1132,89,164,2,0,91,164,40,0,307
586,Nov 24 1992,Friendly in Peru,Peru,Ecuador,1541,1642,1,1,0,0,1541,1642,66,47,0,0,66,47,20,100,-1
587,Nov 25 1992,Friendly in Brazil,Brazil,Uruguay,2003,1865,1,2,-16,16,1987,1881,2,11,0,2,2,13,20,100,238
588,Nov 25 1992,CECAFA Cup in Tanzania,Uganda,Zambia,1499,1644,0,0,8,-8,1507,1636,71,53,4,-4,75,49,40,0,-145
589,Nov 26 1992,Friendly in Argentina,Argentina,Poland,2025,1800,2,0,4,-4,2029,1796,1,21,0,0,1,21,20,100,325
590,Nov 27 1992,Gulf Cup in Qatar,Qatar,Oman,1459,1079,2,0,4,-4,1463,1075,84,175,2,0,86,175,40,100,480
591,Nov 28 1992,Gulf Cup in Qatar,Bahrain,Saudi Arabia,1350,1642,2,1,34,-34,1384,1608,103,58,4,-6,107,52,40,0,-292
592,Nov 28 1992,World Cup qualifier in Honduras,Honduras,St Vincent & Grenadines,1688,1290,4,0,4,-4,1692,1286,31,133,1,-1,32,132,40,100,498
593,Nov 28 1992,Gulf Cup in Qatar,Kuwait,United Arab Emirates,1528,1501,2,0,28,-28,1556,1473,54,86,8,-4,62,82,40,0,27
594,Nov 28 1992,CECAFA Cup in Tanzania,Zambia,Malawi,1636,1457,4,0,20,-20,1656,1437,31,95,9,-2,40,93,40,0,179
595,Nov 29 1992,World Cup qualifier in Costa Rica,Costa Rica,Mexico,1564,1825,2,0,43,-43,1607,1782,46,28,7,-5,53,23,40,100,-161
596,Nov 29 1992,World Cup qualifier in Cyprus,Cyprus,Romania,1326,1819,1,4,-7,7,1319,1826,122,17,-2,1,120,18,40,100,-393
597,Nov 29 1992,Friendly in Uruguay,Uruguay,Poland,1881,1796,0,1,-15,15,1866,1811,17,19,-2,1,15,20,20,100,185
598,Nov 30 1992,Gulf Cup in Qatar,Kuwait,Oman,1556,1075,2,1,2,-2,1558,1073,62,177,0,-1,62,176,30,0,481
599,Nov 30 1992,Gulf Cup in Qatar,Qatar,Bahrain,1463,1384,1,0,11,-11,1474,1373,76,111,5,-2,81,109,40,100,179
600,Dec 1 1992,Gulf Cup in Qatar,United Arab Emirates,Saudi Arabia,1473,1608,1,0,27,-27,1500,1581,73,66,5,-7,78,59,40,0,-135
601,Dec 2 1992,Friendly in China,China,Norway,1464,1772,2,1,15,-15,1479,1757,78,30,4,-2,82,28,20,100,-208
602,Dec 2 1992,Friendly in Guatemala,Guatemala,Jamaica,1462,1417,2,1,6,-6,1468,1411,87,101,0,-2,87,99,20,100,145
603,Dec 2 1992,World Cup qualifier in Israel,Israel,Bulgaria,1592,1781,0,2,-22,22,1570,1803,66,18,-6,3,60,21,40,100,-89
604,Dec 2 1992,Friendly in Malaysia,Malaysia,Uzbekistan,1246,1664,1,1,7,-7,1253,1657,132,42,3,-3,135,39,20,100,-318
605,Dec 3 1992,Gulf Cup in Qatar,Qatar,Kuwait,1474,1558,4,0,36,-36,1510,1522,67,84,8,-11,75,73,40,100,16
606,Dec 4 1992,Gulf Cup in Qatar,Saudi Arabia,Oman,1581,1073,2,0,3,-3,1584,1070,54,178,2,-1,56,177,40,0,508
607,Dec 4 1992,Gulf Cup in Qatar,United Arab Emirates,Bahrain,1500,1373,2,0,19,-19,1519,1354,69,113,5,-2,74,111,40,0,127
608,Dec 5 1992,World Cup qualifier in Honduras,Honduras,Costa Rica,1692,1607,2,1,10,-10,1702,1597,32,54,0,-1,32,53,40,100,185
609,Dec 6 1992,World Cup qualifier in Bermuda,Bermuda,Canada,1374,1526,0,0,3,-3,1377,1523,106,75,1,-2,107,73,40,100,-52
610,Dec 6 1992,World Cup qualifier in El Salvador,El Salvador,Jamaica,1528,1411,2,1,9,-9,1537,1402,64,105,3,-3,67,102,40,100,217
611,Dec 6 1992,World Cup qualifier in Mexico,Mexico,St Vincent & Grenadines,1782,1286,11,0,3,-3,1785,1283,24,132,0,0,24,132,20,0,496
612,Dec 6 1992,Gulf Cup in Qatar,Qatar,United Arab Emirates,1510,1519,1,0,15,-15,1525,1504,68,82,4,-4,72,78,30,0,-9
613,Dec 6 1992,Gulf Cup in Qatar,Saudi Arabia,Kuwait,1584,1522,2,1,16,-16,1600,1506,50,81,3,-4,53,77,40,0,62
614,Dec 7 1992,Gulf Cup in Qatar,Bahrain,Oman,1354,1070,3,0,11,-11,1365,1059,107,179,2,-1,109,178,40,0,284
615,Dec 8 1992,Merlion Tournament in Singapore,Singapore,Malaysia,1215,1253,3,0,22,-22,1237,1231,128,151,11,-8,139,143,30,100,62
616,Dec 9 1992,Gulf Cup in Qatar,United Arab Emirates,Oman,1504,1059,1,0,3,-3,1507,1056,72,180,3,-1,75,179,40,0,445
617,Dec 10 1992,Gulf Cup in Qatar,Bahrain,Kuwait,1365,1506,1,0,28,-28,1393,1478,101,88,4,-5,105,83,40,0,-141
618,Dec 10 1992,Gulf Cup in Qatar,Qatar,Saudi Arabia,1525,1600,0,1,-21,21,1504,1621,82,45,-5,4,77,49,40,100,25
619,Dec 13 1992,World Cup qualifier in Costa Rica,Costa Rica,St Vincent & Grenadines,1597,1283,5,0,7,-7,1604,1276,54,132,0,0,54,132,40,100,414
620,Dec 13 1992,World Cup qualifier in Honduras,Honduras,Mexico,1702,1785,1,1,-1,1,1701,1786,32,24,0,0,32,24,30,100,17
621,Dec 13 1992,Friendly in Niger,Niger,Ghana,1342,1604,0,1,-6,6,1336,1610,115,53,0,0,115,53,20,100,-162
622,Dec 14 1992,Friendly in Guinea,Guinea,Sierra Leone,1408,1511,1,1,0,0,1408,1511,100,73,0,0,100,73,20,100,-3
623,Dec 16 1992,Friendly in Brazil,Brazil,Germany,1987,1986,3,1,11,-11,1998,1975,2,5,0,-1,2,4,20,100,101
624,Dec 16 1992,Friendly in Guinea,Guinea,Sierra Leone,1408,1511,0,0,0,0,1408,1511,100,73,0,0,100,73,20,100,-3
625,Dec 16 1992,World Cup qualifier in Spain,Spain,Latvia,1827,1394,5,0,4,-4,1831,1390,16,110,0,-3,16,107,40,100,533
626,Dec 16 1992,World Cup qualifier in Turkey,Turkey,Netherlands,1585,1956,1,3,-10,10,1575,1966,60,5,-2,0,58,5,40,100,-271
627,Dec 19 1992,World Cup qualifier in Gabon,Gabon,Senegal,1462,1536,3,2,19,-19,1481,1517,76,76,6,-4,82,72,40,100,26
628,Dec 19 1992,World Cup qualifier in Malta,Malta,Italy,1391,1977,1,2,-2,2,1389,1979,108,3,-1,0,107,3,30,100,-486
629,Dec 19 1992,World Cup qualifier in Tanzania,Tanzania,Namibia,1303,1154,2,0,12,-12,1315,1142,120,163,3,0,123,163,40,100,249
630,Dec 20 1992,World Cup qualifier in Botswana,Botswana,Niger,1066,1336,0,1,-11,11,1055,1347,181,111,-2,2,179,113,40,100,-170
631,Dec 20 1992,World Cup qualifier in Congo,Congo,Nigeria,1453,1668,0,1,-14,14,1439,1682,93,33,-1,1,92,34,40,100,-115
632,Dec 20 1992,World Cup qualifier in Ethiopia,Ethiopia,Benin,1377,1176,3,1,9,-9,1386,1167,108,162,0,-2,108,160,40,100,301
633,Dec 20 1992,World Cup qualifier in Ghana,Ghana,Algeria,1610,1648,2,0,25,-25,1635,1623,39,52,7,-4,46,48,30,0,-38
634,Dec 20 1992,World Cup qualifier in Guinea,Guinea,Kenya,1408,1416,4,0,28,-28,1436,1388,88,117,6,-10,94,107,40,100,92
635,Dec 20 1992,World Cup qualifier in Madagascar,Madagascar,Zambia,1470,1656,2,0,37,-37,1507,1619,64,64,11,-12,75,52,40,100,-86
636,Dec 20 1992,World Cup qualifier in Tunisia,Tunisia,Morocco,1549,1592,1,1,-3,3,1546,1595,65,55,-1,0,64,55,40,100,57
637,Dec 20 1992,Friendly in Uruguay,Uruguay,Germany,1866,1975,1,4,-17,17,1849,1992,15,2,0,1,15,3,20,100,-9
638,Dec 20 1992,World Cup qualifier in Zimbabwe,Zimbabwe,Egypt,1497,1648,2,1,23,-23,1520,1625,64,50,8,-3,72,47,40,100,-51
639,Dec 22 1992,Friendly in Cyprus,Cyprus,Georgia,1319,1620,1,0,15,-15,1334,1605,112,55,4,-2,116,53,20,100,-201
640,Dec 26 1992,Friendly in Burkina Faso,Burkina Faso,Mali,1411,1474,3,1,13,-13,1424,1461,95,90,2,-2,97,88,20,100,37
