,date,tournament,home_team,away_team,home_team_rating,away_team_rating,home_goals,away_goals,home_team_rating_change,away_team_rating_change,home_team_new_rating,away_team_new_rating,home_team_rank,away_team_rank,home_team_rank_change,away_team_rank_change,home_team_new_rank,away_team_new_rank,k,hadv,rdiff
0,1996,Friendly in Fiji,Fiji,New Caledonia,1406,1216,1,0,3,-3,1409,1213,99,155,3,-2,102,153,20,100,290
1,1996,Friendly in Fiji,Fiji,New Caledonia,1409,1213,4,0,6,-6,1415,1207,99,155,3,-2,102,153,20,100,296
2,1996,Friendly in Fiji,Fiji,New Caledonia,1415,1207,5,1,5,-5,1420,1202,99,155,3,-2,102,153,20,100,308
3,1996,Friendly in Syria,Syria,Bahrain,1440,1436,2,1,7,-7,1447,1429,94,103,1,-3,95,100,20,100,104
4,Jan 3 1996,Friendly in Lebanon,Lebanon,Kazakhstan,1265,1579,2,1,15,-15,1280,1564,136,67,1,-3,137,64,20,100,-214
5,Jan 3 1996,Friendly in Morocco,Morocco,Tunisia,1585,1573,3,1,10,-10,1595,1563,50,66,4,-1,54,65,20,100,112
6,Jan 5 1996,Friendly in Saudi Arabia,Saudi Arabia,Ghana,1593,1665,1,1,-1,1,1592,1666,56,36,0,1,56,37,20,100,28
7,Jan 5 1996,Friendly in Trinidad and Tobago,Trinidad and Tobago,Venezuela,1559,1333,0,0,-7,7,1552,1340,68,117,-1,0,67,117,20,100,326
8,Jan 6 1996,Friendly in Sierra Leone,Sierra Leone,Liberia,1536,1395,2,1,4,-4,1540,1391,69,111,2,-1,71,110,20,100,241
9,Jan 7 1996,Friendly in Mozambique,Mozambique,Algeria,1400,1582,1,0,12,-12,1412,1570,103,64,2,-2,105,62,20,100,-82
10,Jan 7 1996,Friendly in Trinidad and Tobago,Trinidad and Tobago,Venezuela,1552,1340,0,0,-7,7,1545,1347,71,117,-2,0,69,117,20,100,312
11,Jan 7 1996,Friendly in Zimbabwe,Zimbabwe,Gabon,1499,1487,1,2,-13,13,1486,1500,90,75,-5,5,85,80,20,100,112
12,Jan 8 1996,Friendly in Egypt,Egypt,Tunisia,1637,1563,2,1,5,-5,1642,1558,43,65,1,0,44,65,20,100,174
13,Jan 9 1996,Friendly in Zimbabwe,Zimbabwe,Ghana,1486,1666,1,1,2,-2,1488,1664,85,39,0,-1,85,38,20,100,-80
14,Jan 10 1996,CONCACAF Championship in the United States,Canada,Honduras,1586,1595,3,1,38,-38,1624,1557,38,76,10,-11,48,65,50,0,-9
15,Jan 10 1996,CONCACAF Championship in the United States,El Salvador,Trinidad and Tobago,1520,1545,3,2,27,-27,1547,1518,60,83,8,-7,68,76,50,0,-25
16,Jan 11 1996,CONCACAF Championship in the United States,Mexico,St Vincent & Grenadines,1781,1295,5,0,6,-6,1787,1289,22,133,1,-2,23,131,50,0,486
17,Jan 11 1996,Friendly in Mozambique,Mozambique,Gabon,1412,1500,1,0,10,-10,1422,1490,97,86,4,-3,101,83,20,100,12
18,Jan 12 1996,CONCACAF Championship in the United States,Brazil,Canada,2110,1624,4,1,5,-5,2115,1619,1,52,0,-2,1,50,50,0,486
19,Jan 13 1996,African Nations Cup in South Africa,South Africa,Cameroon,1688,1549,3,0,18,-18,1706,1531,33,79,0,-6,33,73,50,100,239
20,Jan 13 1996,CONCACAF Championship in the United States,United States,Trinidad and Tobago,1707,1518,3,2,8,-8,1715,1510,28,80,2,-2,30,78,30,0,189
21,Jan 14 1996,African Nations Cup in South Africa,Algeria,Zambia,1570,1623,0,0,4,-4,1574,1619,61,50,0,-1,61,49,50,0,-53
22,Jan 14 1996,CONCACAF Championship in the United States,Brazil,Honduras,2115,1557,5,0,4,-4,2119,1553,1,67,0,-1,1,66,50,0,558
23,Jan 14 1996,African Nations Cup in South Africa,Ghana,Ivory Coast,1664,1660,2,0,37,-37,1701,1623,30,55,4,-8,34,47,50,0,4
24,Jan 14 1996,Friendly in Jamaica,Jamaica,Cuba,1541,1517,1,1,-3,3,1538,1520,75,76,-3,0,72,76,20,100,124
25,Jan 14 1996,CONCACAF Championship in the United States,Mexico,Guatemala,1787,1456,1,0,6,-6,1793,1450,23,96,0,-3,23,93,50,0,331
26,Jan 15 1996,African Nations Cup in South Africa,Egypt,Angola,1642,1451,2,1,12,-12,1654,1439,35,101,4,-5,39,96,50,0,191
27,Jan 15 1996,African Nations Cup in South Africa,Sierra Leone,Burkina Faso,1540,1418,2,1,17,-17,1557,1401,61,110,4,-3,65,107,50,0,122
28,Jan 16 1996,CONCACAF Championship in the United States,Guatemala,St Vincent & Grenadines,1450,1289,3,0,25,-25,1475,1264,78,145,7,-7,85,138,50,0,161
29,Jan 16 1996,Friendly in Lebanon,Lebanon,Cyprus,1280,1396,1,0,10,-10,1290,1386,125,116,6,-4,131,112,20,100,-16
30,Jan 16 1996,African Nations Cup in South Africa,Liberia,Gabon,1391,1490,2,1,32,-32,1423,1458,94,97,8,-7,102,90,50,0,-99
31,Jan 16 1996,African Nations Cup in South Africa,Mozambique,Tunisia,1422,1558,1,1,9,-9,1431,1549,99,70,1,-3,100,67,50,0,-136
32,Jan 16 1996,CONCACAF Championship in the United States,United States,El Salvador,1715,1547,2,0,13,-13,1728,1534,28,76,1,-4,29,72,50,100,268
33,Jan 17 1996,Friendly in France,Morocco,Armenia,1595,1281,6,0,6,-6,1601,1275,51,136,2,0,53,136,20,0,314
34,Jan 18 1996,African Nations Cup in South Africa,Algeria,Sierra Leone,1574,1557,2,0,36,-36,1610,1521,41,86,10,-11,51,75,50,0,17
35,Jan 18 1996,African Nations Cup in South Africa,Cameroon,Egypt,1531,1654,2,1,33,-33,1564,1621,53,57,10,-9,63,48,50,0,-123
36,Jan 18 1996,CONCACAF Championship in the United States,United States,Brazil,1728,2119,0,1,-8,8,1720,2127,31,1,-1,0,30,1,50,100,-291
37,Jan 19 1996,African Nations Cup in South Africa,Gabon,Zaire,1458,1540,2,0,46,-46,1504,1494,66,95,12,-13,78,82,50,0,-82
38,Jan 19 1996,African Nations Cup in South Africa,Ghana,Tunisia,1701,1549,2,1,15,-15,1716,1534,28,73,3,-3,31,70,50,0,152
39,Jan 19 1996,CONCACAF Championship in the United States,Mexico,Guatemala,1793,1475,1,0,7,-7,1800,1468,23,89,0,-2,23,87,50,0,318
40,Jan 20 1996,African Nations Cup in South Africa,South Africa,Angola,1706,1439,1,0,5,-5,1711,1434,34,96,0,0,34,96,30,0,267
41,Jan 20 1996,African Nations Cup in South Africa,Zambia,Burkina Faso,1619,1401,5,1,21,-21,1640,1380,39,116,5,-4,44,112,50,0,218
42,Jan 21 1996,African Nations Cup in South Africa,Ivory Coast,Mozambique,1623,1431,1,0,12,-12,1635,1419,43,108,2,-4,45,104,50,0,192
43,Jan 21 1996,CONCACAF Championship in the United States,Mexico,Brazil,1800,2127,2,0,65,-65,1865,2062,5,1,9,0,14,1,50,0,-327
44,Jan 21 1996,CONCACAF Championship in the United States,United States,Guatemala,1720,1468,3,0,10,-10,1730,1458,28,93,1,-3,29,90,30,0,252
45,Jan 24 1996,African Nations Cup in South Africa,Algeria,Burkina Faso,1610,1380,2,1,11,-11,1621,1369,47,116,2,-2,49,114,50,0,230
46,Jan 24 1996,African Nations Cup in South Africa,Angola,Cameroon,1434,1564,3,3,9,-9,1443,1555,96,67,0,-2,96,65,50,0,-130
47,Jan 24 1996,Friendly in France,France,Portugal,1957,1863,3,2,5,-5,1962,1858,6,15,0,0,6,15,20,100,194
48,Jan 24 1996,Friendly in Greece,Greece,Israel,1597,1643,2,1,8,-8,1605,1635,50,48,3,-3,53,45,20,100,54
49,Jan 24 1996,Friendly in Italy,Italy,Wales,1988,1623,3,0,2,-2,1990,1621,3,50,0,-1,3,49,20,100,465
50,Jan 24 1996,Asian Cup qualifier in Saudi Arabia,Saudi Arabia,Kyrgyzstan,1592,1194,3,0,4,-4,1596,1190,57,158,0,-1,57,157,40,100,498
51,Jan 24 1996,African Nations Cup in South Africa,South Africa,Egypt,1711,1621,0,1,-37,37,1674,1658,38,31,-2,9,36,40,50,100,190
52,Jan 24 1996,African Nations Cup in South Africa,Zambia,Sierra Leone,1640,1521,4,0,31,-31,1671,1490,30,92,7,-9,37,83,50,0,119
53,Jan 25 1996,African Nations Cup in South Africa,Ghana,Mozambique,1716,1419,2,0,11,-11,1727,1408,29,106,1,-1,30,105,50,0,297
54,Jan 25 1996,African Nations Cup in South Africa,Tunisia,Ivory Coast,1534,1635,3,1,48,-48,1582,1587,50,71,10,-13,60,58,50,0,-101
55,Jan 25 1996,African Nations Cup in South Africa,Zaire,Liberia,1494,1423,2,0,30,-30,1524,1393,67,113,7,-6,74,107,50,0,71
56,Jan 26 1996,Asian Cup qualifier in Saudi Arabia,Yemen,Kyrgyzstan,1196,1190,1,0,20,-20,1216,1170,147,165,4,-4,151,161,40,0,6
57,Jan 27 1996,African Nations Cup in South Africa,South Africa,Algeria,1674,1621,2,1,15,-15,1689,1606,34,54,1,-3,35,51,50,100,153
58,Jan 27 1996,African Nations Cup in South Africa,Zambia,Egypt,1671,1658,3,1,36,-36,1707,1622,31,54,3,-7,34,47,50,0,13
59,Jan 28 1996,African Nations Cup in South Africa,Gabon,Tunisia,1504,1582,1,1,6,-6,1510,1576,76,64,1,-2,77,62,50,0,-78
60,Jan 28 1996,African Nations Cup in South Africa,Ghana,Zaire,1727,1524,1,0,12,-12,1739,1512,26,76,2,-1,28,75,50,0,203
61,Jan 28 1996,Asian Cup qualifier in Saudi Arabia,Saudi Arabia,Yemen,1596,1216,4,0,4,-4,1600,1212,56,151,0,0,56,151,20,0,380
62,Jan 30 1996,Asian Cup qualifier in Hong Kong,China,Macao,1609,1023,7,1,3,-3,1612,1020,50,187,0,-1,50,186,40,0,586
63,Jan 30 1996,Asian Cup qualifier in Hong Kong,Hong Kong,Philippines,1203,813,8,0,5,-5,1208,808,153,206,0,0,153,206,20,0,390
64,Jan 31 1996,Asian Cup qualifier in Saudi Arabia,Saudi Arabia,Kyrgyzstan,1600,1170,2,0,3,-3,1603,1167,54,161,1,0,55,161,30,0,430
65,Jan 31 1996,African Nations Cup in South Africa,South Africa,Ghana,1689,1739,3,0,37,-37,1726,1702,25,40,5,-6,30,34,50,100,50
66,Jan 31 1996,African Nations Cup in South Africa,Tunisia,Zambia,1576,1707,4,2,51,-51,1627,1656,30,44,16,-5,46,39,50,0,-131
67,Feb 1 1996,Asian Cup qualifier in Hong Kong,China,Philippines,1612,808,7,0,1,-1,1613,807,51,206,0,0,51,206,30,0,804
68,Feb 1 1996,Asian Cup qualifier in Hong Kong,Hong Kong,Macao,1208,1020,4,1,11,-11,1219,1009,149,194,2,-4,151,190,40,100,288
69,Feb 2 1996,Asian Cup qualifier in Saudi Arabia,Kyrgyzstan,Yemen,1167,1212,3,1,34,-34,1201,1178,147,170,7,-9,154,161,40,0,-45
70,Feb 2 1996,Friendly in Venezuela,Venezuela,Ecuador,1347,1670,0,1,-4,4,1343,1674,117,37,0,0,117,37,20,100,-223
71,Feb 3 1996,African Nations Cup in South Africa,South Africa,Tunisia,1726,1627,2,0,18,-18,1744,1609,26,56,2,-5,28,51,50,100,199
72,Feb 3 1996,African Nations Cup in South Africa,Zambia,Ghana,1656,1702,1,0,28,-28,1684,1674,31,40,4,-3,35,37,50,0,-46
73,Feb 4 1996,Friendly in Bolivia,Bolivia,Chile,1666,1683,1,1,-2,2,1664,1685,39,34,0,1,39,35,20,100,83
74,Feb 4 1996,Asian Cup qualifier in Hong Kong,Hong Kong,China,1219,1613,0,2,-9,9,1210,1622,153,44,-1,3,152,47,40,100,-294
75,Feb 4 1996,Asian Cup qualifier in Hong Kong,Macao,Philippines,1009,807,5,1,18,-18,1027,789,180,206,5,0,185,206,40,0,202
76,Feb 4 1996,Asian Cup qualifier in Saudi Arabia,Saudi Arabia,Yemen,1603,1178,1,0,2,-2,1605,1176,51,161,2,0,53,161,20,0,425
77,Feb 7 1996,Friendly in Chile,Chile,Mexico,1685,1865,2,1,12,-12,1697,1853,33,16,1,-1,34,15,20,100,-80
78,Feb 7 1996,Friendly tournament in Malta,Malta,Russia,1321,1899,0,2,-3,3,1318,1902,122,9,-1,0,121,9,30,100,-478
79,Feb 7 1996,Friendly in Morocco,Morocco,Luxembourg,1601,1254,2,0,2,-2,1603,1252,58,141,-1,0,57,141,20,100,447
80,Feb 7 1996,Friendly tournament in Malta,Slovenia,Iceland,1590,1577,7,1,31,-31,1621,1546,40,72,9,-5,49,67,30,0,13
81,Feb 7 1996,Friendly in Spain,Spain,Norway,1986,1804,1,0,3,-3,1989,1801,4,23,0,0,4,23,20,100,282
82,Feb 9 1996,Friendly tournament in Malta,Malta,Slovenia,1318,1621,0,0,8,-8,1326,1613,115,53,3,-2,118,51,30,100,-203
83,Feb 9 1996,Friendly tournament in Malta,Russia,Iceland,1902,1546,3,0,6,-6,1908,1540,9,69,0,-1,9,68,30,0,356
84,Feb 9 1996,King's Cup in Thailand,Thailand,Finland,1402,1529,1,0,16,-16,1418,1513,100,76,3,-2,103,74,30,100,-27
85,Feb 10 1996,Friendly in Australia,Australia,Japan,1712,1627,1,4,-26,26,1686,1653,37,36,-2,5,35,41,20,100,185
86,Feb 11 1996,Friendly in Lebanon,Lebanon,Ecuador,1290,1674,1,0,17,-17,1307,1657,123,41,4,-2,127,39,20,100,-284
87,Feb 11 1996,Friendly tournament in Malta,Malta,Iceland,1326,1540,1,4,-18,18,1308,1558,134,60,-8,4,126,64,30,100,-114
88,Feb 11 1996,Friendly in Peru,Peru,Bolivia,1578,1664,1,3,-16,16,1562,1680,65,35,-2,2,63,37,20,100,14
89,Feb 11 1996,Friendly tournament in Malta,Russia,Slovenia,1908,1613,3,1,7,-7,1915,1606,9,53,0,-1,9,52,30,0,295
90,Feb 14 1996,Friendly in Australia,Australia,Japan,1686,1653,3,0,11,-11,1697,1642,33,45,1,-2,34,43,20,100,133
91,Feb 14 1996,Friendly in Bolivia,Bolivia,Paraguay,1680,1765,4,1,17,-17,1697,1748,31,28,3,-1,34,27,20,100,15
92,Feb 14 1996,Friendly in Chile,Chile,Peru,1697,1562,4,0,8,-8,1705,1554,33,69,0,-3,33,66,20,100,235
93,Feb 14 1996,Friendly in Turkey,Turkey,Belarus,1759,1462,3,2,2,-2,1761,1460,25,89,1,0,26,89,20,100,397
94,Feb 16 1996,Friendly in Cyprus,Azerbaijan,Estonia,1453,1089,0,0,-8,8,1445,1097,97,171,-3,2,94,173,20,0,364
95,Feb 16 1996,Friendly in Saudi Arabia,Ecuador,Oman,1657,1287,2,0,3,-3,1660,1284,39,134,0,0,39,134,20,0,370
96,Feb 16 1996,King's Cup in Thailand,Thailand,Finland,1418,1513,5,2,26,-26,1444,1487,87,96,8,-11,95,85,30,100,5
97,Feb 18 1996,Friendly in Qatar,Qatar,Ecuador,1421,1660,1,1,4,-4,1425,1656,102,39,0,0,102,39,20,100,-139
98,Feb 19 1996,Friendly tournament in Hong Kong,Japan,Poland,1642,1715,5,0,36,-36,1678,1679,33,42,5,-5,38,37,30,0,-73
99,Feb 20 1996,Friendly in Cyprus,Cyprus,Estonia,1386,1097,1,0,2,-2,1388,1095,111,173,0,0,111,173,20,100,389
100,Feb 21 1996,Friendly in France,France,Greece,1962,1605,3,1,2,-2,1964,1603,6,58,0,-2,6,56,20,100,457
101,Feb 21 1996,Friendly in Israel,Israel,Lithuania,1635,1433,4,2,4,-4,1639,1429,45,102,0,-2,45,100,20,100,302
102,Feb 21 1996,Friendly in Portugal,Portugal,Germany,1858,2031,1,2,-8,8,1850,2039,16,2,-1,0,15,2,20,100,-73
103,Feb 22 1996,Friendly tournament in Hong Kong,Japan,Sweden,1678,1847,1,1,7,-7,1685,1840,34,20,2,-2,36,18,30,0,-169
104,Feb 23 1996,Friendly in Qatar,Ecuador,Kuwait,1656,1493,3,0,10,-10,1666,1483,40,89,0,-4,40,85,20,0,163
105,Feb 23 1996,Friendly in Thailand,Thailand,Indonesia,1444,1250,4,1,5,-5,1449,1245,91,144,2,-1,93,143,20,100,294
106,Feb 24 1996,Friendly in Estonia,Estonia,Faroe Islands,1095,1190,2,2,0,0,1095,1190,173,157,0,0,173,157,20,100,5
107,Feb 24 1996,Friendly in Kuwait,Kuwait,Oman,1483,1284,1,0,3,-3,1486,1281,85,136,0,-1,85,135,20,100,299
108,Feb 25 1996,Friendly in Australia,Australia,Sweden,1697,1840,0,2,-13,13,1684,1853,39,10,-3,4,36,14,20,100,-43
109,Feb 25 1996,Friendly in Qatar,Qatar,Ecuador,1425,1666,1,2,-6,6,1419,1672,104,40,-1,0,103,40,20,100,-141
110,Feb 27 1996,Friendly in Cyprus,Azerbaijan,Faroe Islands,1445,1190,3,0,7,-7,1452,1183,87,161,4,-2,91,159,20,0,255
111,Feb 28 1996,Friendly in Australia,Australia,Sweden,1684,1853,0,0,2,-2,1686,1851,34,16,1,-1,35,15,20,100,-69
112,Feb 28 1996,Friendly in Croatia,Croatia,Poland,1883,1679,2,1,3,-3,1886,1676,12,38,0,0,12,38,20,100,304
113,Mar 2 1996,Asian Cup qualifier in Malaysia,Malaysia,Indonesia,1241,1245,0,0,-5,5,1236,1250,146,141,-1,1,145,142,40,100,96
114,Mar 2 1996,Friendly in Oman,Oman,Kuwait,1281,1486,0,3,-12,12,1269,1498,139,73,-2,6,137,79,20,100,-105
115,Mar 3 1996,Caribbean Cup qualifier in Dominica,Dominica,Saint Lucia,1191,1274,0,1,-21,21,1170,1295,166,124,-5,6,161,130,40,100,17
116,Mar 3 1996,Friendly in Jamaica,Jamaica,Guatemala,1538,1458,2,0,8,-8,1546,1450,66,94,2,-2,68,92,20,100,180
117,Mar 4 1996,Asian Cup qualifier in Malaysia,Indonesia,India,1250,1095,7,1,25,-25,1275,1070,130,183,6,-5,136,178,40,0,155
118,Mar 5 1996,Friendly in Syria,Syria,Kuwait,1447,1498,0,2,-17,17,1430,1515,103,69,-4,5,99,74,20,100,49
119,Mar 6 1996,Friendly in the United States,Colombia,Honduras,1844,1553,2,1,3,-3,1847,1550,17,67,0,0,17,67,20,0,291
120,Mar 6 1996,Asian Cup qualifier in Malaysia,Malaysia,India,1236,1070,5,2,12,-12,1248,1058,141,182,2,-2,143,180,40,100,266
121,Mar 6 1996,Friendly in Trinidad and Tobago,Trinidad and Tobago,Haiti,1510,1310,2,0,5,-5,1515,1305,71,129,3,-2,74,127,20,100,300
122,Mar 7 1996,Friendly in Bolivia,Bolivia,Peru,1697,1554,2,0,6,-6,1703,1548,33,68,0,-1,33,67,20,100,243
123,Mar 10 1996,World Cup qualifier in Dominica,Dominica,Antigua and Barbuda,1170,1151,3,3,-7,7,1163,1158,161,163,0,0,161,163,40,100,119
124,Mar 10 1996,Asian Cup qualifier in Turkmenistan,Turkmenistan,Kuwait,1511,1515,2,2,-5,5,1506,1520,79,72,-1,1,78,73,40,100,96
125,Mar 12 1996,Friendly in Cyprus,Cyprus,Latvia,1388,1433,1,0,8,-8,1396,1425,103,105,4,-4,107,101,20,100,55
126,Mar 13 1996,Friendly in Croatia,Croatia,South Korea,1886,1629,3,0,4,-4,1890,1625,12,46,0,0,12,46,20,100,357
127,Mar 13 1996,Friendly in Luxembourg,Luxembourg,Switzerland,1252,1829,1,1,9,-9,1261,1820,138,23,2,-1,140,22,20,0,-577
128,Mar 16 1996,Friendly in Kuwait,Kuwait,Finland,1520,1487,0,1,-14,14,1506,1501,81,75,-4,5,77,80,20,100,133
129,Mar 19 1996,Friendly tournament in the United Arab Emirates,United Arab Emirates,South Korea,1529,1625,3,2,15,-15,1544,1610,68,54,2,-4,70,50,30,100,4
130,Mar 20 1996,Friendly tournament in the United Arab Emirates,Morocco,Egypt,1603,1622,2,0,24,-24,1627,1598,36,70,10,-12,46,58,30,0,-19
131,Mar 21 1996,Friendly in Colombia,Colombia,Trinidad and Tobago,1847,1515,3,0,3,-3,1850,1512,15,74,1,0,16,74,20,100,432
132,Mar 21 1996,Caribbean Cup qualifier in Saint Lucia,Saint Lucia,Dominica,1295,1163,1,1,-12,12,1283,1175,138,161,-4,0,134,161,40,100,232
133,Mar 22 1996,Asian Cup qualifier in Kuwait,Kuwait,Turkmenistan,1506,1506,2,0,22,-22,1528,1484,69,93,4,-8,73,85,30,0,0
134,Mar 22 1996,Friendly tournament in the United Arab Emirates,United Arab Emirates,Egypt,1544,1598,0,0,-2,2,1542,1600,70,58,0,0,70,58,30,100,46
135,Mar 23 1996,Friendly tournament in the United Arab Emirates,Morocco,South Korea,1627,1610,2,2,-1,1,1626,1611,46,50,0,0,46,50,30,0,17
136,Mar 23 1996,Caribbean Cup qualifier in the Netherlands Antilles,Netherlands Antilles,Grenada,1311,1295,0,1,-26,26,1285,1321,143,110,-10,10,133,120,40,100,116
137,Mar 24 1996,World Cup qualifier in the Dominican Republic,Dominican Republic,Aruba,1020,1011,3,2,14,-14,1034,997,179,190,4,0,183,190,40,100,109
138,Mar 24 1996,Caribbean Cup qualifier in French Guiana,French Guiana,Suriname,1200,1300,1,2,-20,20,1180,1320,163,115,-4,7,159,122,40,100,0
139,Mar 25 1996,Friendly tournament in the United Arab Emirates,Egypt,South Korea,1600,1611,1,1,0,0,1600,1611,58,50,0,0,58,50,20,0,-11
140,Mar 26 1996,Friendly in Croatia,Croatia,Israel,1890,1639,2,0,4,-4,1894,1635,10,45,1,0,11,45,20,100,351
141,Mar 26 1996,Friendly in Czechia,Czechia,Turkey,1896,1761,3,0,7,-7,1903,1754,10,26,0,0,10,26,20,100,235
142,Mar 26 1996,Friendly tournament in the United Arab Emirates,United Arab Emirates,Morocco,1542,1626,1,0,14,-14,1556,1612,60,52,5,-3,65,49,30,100,16
143,Mar 27 1996,Friendly in Austria,Austria,Switzerland,1654,1820,1,0,12,-12,1666,1808,41,24,0,-1,41,23,20,100,-66
144,Mar 27 1996,Friendly in Belgium,Belgium,France,1777,1964,0,2,-11,11,1766,1975,25,4,0,1,25,5,20,100,-87
145,Mar 27 1996,Friendly in Brazil,Brazil,Ghana,2062,1674,8,2,2,-2,2064,1672,1,37,0,1,1,38,20,100,488
146,Mar 27 1996,Friendly in Cyprus,Cyprus,Georgia,1396,1642,0,2,-9,9,1387,1651,115,40,-4,2,111,42,20,100,-146
147,Mar 27 1996,Friendly in England,England,Bulgaria,1869,1835,1,0,6,-6,1875,1829,13,20,0,0,13,20,20,100,134
148,Mar 27 1996,Friendly in Germany,Germany,Denmark,2039,1970,2,0,8,-8,2047,1962,2,7,0,-1,2,6,20,100,169
149,Mar 27 1996,Friendly in Guatemala,Guatemala,Venezuela,1450,1343,3,0,8,-8,1458,1335,86,117,3,0,89,117,20,100,207
150,Mar 27 1996,Friendly in Honduras,Honduras,Nicaragua,1550,941,1,0,0,0,1550,941,67,194,0,0,67,194,20,100,709
151,Mar 27 1996,Friendly in Ireland,Ireland,Russia,1737,1915,0,2,-12,12,1725,1927,33,7,-2,1,31,8,20,100,-78
152,Mar 27 1996,Friendly in Macedonia,Macedonia,Malta,1539,1308,1,0,3,-3,1542,1305,71,128,0,-1,71,127,20,100,331
153,Mar 27 1996,Friendly in Northern Ireland,Northern Ireland,Norway,1652,1801,0,2,-13,13,1639,1814,46,21,-2,1,44,22,20,100,-49
154,Mar 27 1996,Friendly in Poland,Poland,Slovenia,1676,1606,0,0,-5,5,1671,1611,42,48,-2,2,40,50,20,100,170
155,Mar 27 1996,Friendly in Portugal,Portugal,Greece,1850,1603,1,0,2,-2,1852,1601,14,56,1,0,15,56,20,100,347
156,Mar 27 1996,Friendly in Scotland,Scotland,Australia,1783,1686,1,0,5,-5,1788,1681,24,39,0,-2,24,37,20,100,197
157,Mar 27 1996,Friendly in Slovakia,Slovakia,Belarus,1687,1460,4,0,5,-5,1692,1455,34,91,0,-1,34,90,20,100,327
158,Mar 27 1996,Caribbean Cup qualifier in Saint Kitts and Nevis,Saint Kitts and Nevis,Anguilla,1145,526,8,0,1,-1,1146,525,164,219,0,0,164,219,20,0,619
159,Mar 27 1996,Friendly in Yugoslavia,Yugoslavia,Romania,1942,1893,1,0,6,-6,1948,1887,7,12,0,0,7,12,20,100,149
160,Mar 28 1996,Friendly in Colombia,Colombia,Bolivia,1850,1703,4,1,7,-7,1857,1696,11,33,3,0,14,33,20,100,247
161,Mar 29 1996,World Cup qualifier in Guyana,Guyana,Grenada,1073,1321,1,2,-12,12,1061,1333,181,116,-2,2,179,118,40,100,-148
162,Mar 29 1996,Caribbean Cup qualifier in Saint Kitts and Nevis,Sint Maarten,Anguilla,964,525,4,0,6,-6,970,519,190,219,1,0,191,219,40,0,439
163,Mar 31 1996,World Cup qualifier in Antigua and Barbuda,Antigua and Barbuda,Dominica,1158,1175,1,3,-37,37,1121,1212,173,141,-5,10,168,151,40,100,83
164,Mar 31 1996,World Cup qualifier in Aruba,Aruba,Dominican Republic,997,1034,1,3,-35,35,962,1069,192,171,-1,6,191,177,40,100,63
165,Mar 31 1996,Caribbean Cup qualifier in Saint Kitts and Nevis,Saint Kitts and Nevis,Sint Maarten,1146,970,3,0,12,-12,1158,958,162,195,1,-2,163,193,40,100,276
166,Mar 31 1996,World Cup qualifier in Suriname,Suriname,Jamaica,1320,1546,0,1,-13,13,1307,1559,128,57,-3,6,125,63,40,100,-126
167,Apr 7 1996,World Cup qualifier in Grenada,Grenada,Guyana,1333,1061,6,0,9,-9,1342,1052,116,182,1,-1,117,181,40,100,372
168,Apr 8 1996,Friendly in Congo,Congo,Zaire,1363,1512,2,1,11,-11,1374,1501,112,81,2,-3,114,78,20,100,-49
169,Apr 9 1996,Friendly in Azerbaijan,Azerbaijan,Turkey,1452,1754,0,1,-5,5,1447,1759,97,26,-3,0,94,26,20,100,-202
170,Apr 9 1996,Friendly in Moldova,Moldova,Ukraine,1466,1584,2,2,1,-1,1467,1583,87,60,0,0,87,60,20,100,-18
171,Apr 10 1996,Friendly in Croatia,Croatia,Hungary,1894,1604,4,1,3,-3,1897,1601,11,55,0,0,11,55,20,100,390
172,Apr 14 1996,Caribbean Cup qualifier in Suriname,Suriname,French Guiana,1307,1180,1,1,-11,11,1296,1191,133,152,-4,4,129,156,40,100,227
173,Apr 21 1996,Friendly in Ethiopia,Ethiopia,Ghana,1311,1672,2,0,25,-25,1336,1647,112,48,6,-5,118,43,20,100,-261
174,Apr 21 1996,Friendly in The Gambia,Gambia,Senegal,1322,1463,1,2,-9,9,1313,1472,128,84,-4,2,124,86,20,100,-41
175,Apr 21 1996,World Cup qualifier in Jamaica,Jamaica,Suriname,1559,1296,1,0,4,-4,1563,1292,63,131,0,-1,63,130,20,0,263
176,Apr 21 1996,Friendly in Qatar,Qatar,Kuwait,1419,1528,3,1,15,-15,1434,1513,91,75,6,-1,97,74,20,100,-9
177,Apr 24 1996,World Cup qualifier in Argentina,Argentina,Bolivia,1843,1696,3,1,12,-12,1855,1684,14,39,2,-3,16,36,40,100,247
178,Apr 24 1996,Friendly in Belgium,Belgium,Russia,1766,1927,0,0,2,-2,1768,1925,25,8,0,0,25,8,20,100,-61
179,Apr 24 1996,Friendly in Bosnia and Herzegovina,Bosnia and Herzegovina,Albania,1601,1450,0,0,-6,6,1595,1456,57,88,-1,2,56,90,20,100,251
180,Apr 24 1996,Friendly in Chile,Chile,Australia,1705,1681,3,0,12,-12,1717,1669,32,43,0,-3,32,40,20,100,124
181,Apr 24 1996,World Cup qualifier in Colombia,Colombia,Paraguay,1857,1748,1,0,9,-9,1866,1739,14,27,0,0,14,27,40,100,209
182,Apr 24 1996,Friendly in Czechia,Czechia,Ireland,1903,1725,2,0,5,-5,1908,1720,8,31,1,0,9,31,20,100,278
183,Apr 24 1996,Friendly in Denmark,Denmark,Scotland,1962,1788,2,0,5,-5,1967,1783,6,24,0,0,6,24,20,100,274
184,Apr 24 1996,World Cup qualifier in Ecuador,Ecuador,Peru,1672,1548,4,1,15,-15,1687,1533,30,75,4,-3,34,72,40,100,224
185,Apr 24 1996,Friendly in England,England,Croatia,1875,1897,0,0,-2,2,1873,1899,13,11,0,0,13,11,20,100,78
186,Apr 24 1996,Friendly in Estonia,Estonia,Iceland,1095,1558,0,3,-4,4,1091,1562,173,64,0,0,173,64,20,100,-363
187,Apr 24 1996,World Cup qualifier in Greece,Greece,Slovenia,1601,1611,2,0,22,-22,1623,1589,37,64,9,-7,46,57,40,100,90
188,Apr 24 1996,Caribbean Cup qualifier in Grenada,Grenada,St Vincent & Grenadines,1342,1264,1,1,-9,9,1333,1273,119,137,-1,1,118,138,40,100,178
189,Apr 24 1996,Friendly in Hungary,Hungary,Austria,1601,1666,0,2,-17,17,1584,1683,63,36,-4,2,59,38,20,100,35
190,Apr 24 1996,Caribbean Cup qualifier in Jamaica,Jamaica,Barbados,1563,1259,2,0,5,-5,1568,1254,61,143,1,-1,62,142,40,100,404
191,Apr 24 1996,World Cup qualifier in Macedonia,Macedonia,Liechtenstein,1542,1100,3,0,3,-3,1545,1097,69,172,1,0,70,172,20,0,442
192,Apr 24 1996,Caribbean Cup qualifier in Martinique,Martinique,Saint Lucia,1469,1283,1,0,6,-6,1475,1277,85,136,1,-1,86,135,40,100,286
193,Apr 24 1996,Friendly in the Netherlands,Netherlands,Germany,1916,2047,0,1,-9,9,1907,2056,11,2,-1,0,10,2,20,100,-31
194,Apr 24 1996,Friendly in Norway,Norway,Spain,1814,1989,0,0,2,-2,1816,1987,22,4,0,0,22,4,20,100,-75
195,Apr 24 1996,Friendly in Northern Ireland,Northern Ireland,Sweden,1639,1851,1,2,-7,7,1632,1858,46,13,-1,2,45,15,20,100,-112
196,Apr 24 1996,Friendly in Romania,Romania,Georgia,1887,1651,5,0,5,-5,1892,1646,12,45,0,-2,12,43,20,100,336
197,Apr 24 1996,Friendly in Slovakia,Slovakia,Bulgaria,1692,1829,0,0,1,-1,1693,1828,32,20,1,0,33,20,20,100,-37
198,Apr 24 1996,Friendly tournament in South Africa,South Africa,Brazil,1744,2064,2,3,-7,7,1737,2071,28,1,0,0,28,1,30,100,-220
199,Apr 24 1996,Friendly in Switzerland,Switzerland,Wales,1808,1621,2,0,5,-5,1813,1616,23,51,0,-2,23,49,20,100,287
200,Apr 24 1996,World Cup qualifier in Venezuela,Venezuela,Uruguay,1335,1838,0,2,-5,5,1330,1843,119,19,0,0,119,19,40,100,-403
201,Apr 24 1996,World Cup qualifier in Yugoslavia,Yugoslavia,Faroe Islands,1948,1183,3,1,0,0,1948,1183,7,159,0,0,7,159,20,0,765
202,Apr 26 1996,Caribbean Cup qualifier in the Cayman Islands,Cayman Islands,Cuba,1067,1520,0,4,-9,9,1058,1529,178,73,0,0,178,73,40,100,-353
203,Apr 26 1996,Caribbean Cup qualifier in Haiti,Haiti,Dominican Republic,1305,1069,6,0,11,-11,1316,1058,122,179,2,-1,124,178,40,100,336
204,Apr 26 1996,Friendly in Turkmenistan,Turkmenistan,Iran,1484,1546,1,1,-1,1,1483,1547,85,69,0,0,85,69,20,100,38
205,Apr 28 1996,Caribbean Cup qualifier in Barbados,Barbados,Jamaica,1254,1568,2,0,46,-46,1300,1522,116,84,13,-11,129,73,40,100,-214
206,Apr 28 1996,Caribbean Cup qualifier in Haiti,Haiti,Dominican Republic,1316,1058,1,1,-15,15,1301,1073,132,176,-4,1,128,177,40,100,358
207,Apr 28 1996,Caribbean Cup qualifier in Saint Lucia,Saint Lucia,Martinique,1277,1475,0,1,-15,15,1262,1490,145,78,-5,4,140,82,40,100,-98
208,Apr 28 1996,Caribbean Cup qualifier in St Vincent & Grenadines,St Vincent & Grenadines,Grenada,1273,1333,3,1,27,-27,1300,1306,120,132,9,-7,129,125,40,100,40
209,Apr 28 1996,Caribbean Cup qualifier in Suriname,Suriname,Guyana,1292,1052,2,1,5,-5,1297,1047,132,183,-1,-1,131,182,40,100,340
210,Apr 28 1996,Friendly in Turkmenistan,Turkmenistan,Iran,1483,1547,0,1,-11,11,1472,1558,87,59,-1,5,86,64,20,100,36
211,Apr 28 1996,Friendly in Zaire,Zaire,Congo,1501,1374,3,1,6,-6,1507,1368,76,116,1,-1,77,115,20,100,227
212,Apr 30 1996,Friendly in Israel,Israel,South Korea,1635,1611,4,5,-13,13,1622,1624,50,39,-3,6,47,45,20,100,124
213,May 1 1996,Friendly in Poland,Poland,Belarus,1671,1455,1,1,-7,7,1664,1462,41,87,-1,2,40,89,20,100,316
214,May 1 1996,Friendly in Turkey,Turkey,Ukraine,1759,1583,3,2,3,-3,1762,1580,26,60,0,0,26,60,20,100,276
215,May 4 1996,World Cup qualifier in the Dominican Republic,Dominican Republic,Netherlands Antilles,1073,1285,2,1,26,-26,1099,1259,167,147,5,-6,172,141,40,100,-112
216,May 4 1996,World Cup qualifier in Puerto Rico,Puerto Rico,St Vincent & Grenadines,1063,1300,1,2,-12,12,1051,1312,182,119,-2,5,180,124,40,100,-137
217,May 5 1996,Friendly in the United States,Bolivia,El Salvador,1684,1534,1,1,-4,4,1680,1538,40,70,-2,0,38,70,20,0,150
218,May 5 1996,Caribbean Cup qualifier in Guyana,Guyana,Suriname,1047,1297,2,1,28,-28,1075,1269,172,143,5,-6,177,137,40,100,-150
219,May 5 1996,World Cup qualifier in Nicaragua,Nicaragua,Guatemala,941,1458,0,1,-3,3,938,1461,194,90,0,0,194,90,40,100,-417
220,May 5 1996,World Cup qualifier in Saint Kitts and Nevis,Saint Kitts and Nevis,Saint Lucia,1158,1262,5,1,38,-38,1196,1224,149,161,7,-11,156,150,40,100,-4
221,May 8 1996,Friendly in Greece,Greece,Georgia,1623,1646,2,1,8,-8,1631,1638,44,43,1,0,45,43,20,100,77
222,May 8 1996,Asian Cup qualifier in Tajikistan,Tajikistan,Uzbekistan,1377,1726,4,0,61,-61,1438,1665,82,48,15,-9,97,39,40,100,-249
223,May 9 1996,Friendly in Sweden,Sweden,Slovakia,1858,1693,2,1,4,-4,1862,1689,15,32,0,0,15,32,20,100,265
224,May 10 1996,World Cup qualifier in Guatemala,Guatemala,Nicaragua,1461,938,2,1,1,-1,1462,937,88,194,1,0,89,194,20,0,523
225,May 11 1996,Friendly in Malawi,Malawi,Zambia,1432,1684,0,1,-6,6,1426,1690,105,29,-3,3,102,32,20,100,-152
226,May 11 1996,World Cup qualifier in the Netherlands Antilles,Netherlands Antilles,Dominican Republic,1259,1099,0,0,-13,13,1246,1112,146,166,-3,3,143,169,40,100,260
227,May 11 1996,Oceania Nations Cup in Tahiti,Tahiti,Solomon Islands,1570,1289,2,1,5,-5,1575,1284,61,134,0,-1,61,133,30,0,281
228,May 12 1996,Friendly in Burkina Faso,Burkina Faso,Niger,1369,1321,0,0,-4,4,1365,1325,118,122,-2,-1,116,121,20,100,148
229,May 12 1996,World Cup qualifier in the Cayman Islands,Cayman Islands,Cuba,1058,1529,0,1,-4,4,1054,1533,181,70,-1,1,180,71,40,100,-371
230,May 12 1996,World Cup qualifier in Haiti,Haiti,Grenada,1301,1306,6,1,29,-29,1330,1277,109,142,10,-8,119,134,40,100,95
231,May 12 1996,Asian Cup qualifier in Lebanon,Lebanon,Turkmenistan,1307,1472,3,1,36,-36,1343,1436,109,108,8,-11,117,97,40,100,-65
232,May 12 1996,Friendly in Malawi,Malawi,Zambia,1426,1690,1,1,4,-4,1430,1686,96,36,3,-2,99,34,20,100,-164
233,May 12 1996,World Cup qualifier in St Vincent & Grenadines,St Vincent & Grenadines,Puerto Rico,1312,1051,7,0,10,-10,1322,1041,122,183,1,-1,123,182,40,100,361
234,May 12 1996,Friendly in Swaziland,Swaziland,Mozambique,1231,1408,0,1,-8,8,1223,1416,155,103,-5,2,150,105,20,100,-77
235,May 14 1996,World Cup qualifier in the Cayman Islands,Cayman Islands,Cuba,1054,1533,0,5,-8,8,1046,1541,182,69,-1,1,181,70,40,100,-379
236,May 14 1996,World Cup qualifier in Dominica,Dominica,Barbados,1212,1300,0,1,-21,21,1191,1321,161,119,-5,5,156,124,40,100,12
237,May 16 1996,Friendly in South Korea,South Korea,Sweden,1624,1862,0,2,-9,9,1615,1871,54,13,-4,1,50,14,20,100,-138
238,May 17 1996,Friendly in Iran,Iran,Qatar,1558,1434,2,0,6,-6,1564,1428,60,106,2,-4,62,102,20,100,224
239,May 17 1996,Friendly in Mauritania,Mauritania,Senegal,1255,1472,0,0,3,-3,1258,1469,140,86,0,0,140,86,20,100,-117
240,May 18 1996,Friendly in England,England,Hungary,1873,1584,3,0,3,-3,1876,1581,13,59,0,0,13,59,20,100,389
241,May 18 1996,World Cup qualifier in Grenada,Grenada,Haiti,1277,1330,0,1,-23,23,1254,1353,146,115,-6,2,140,117,40,100,47
242,May 18 1996,Friendly in the United States,Mexico,Slovakia,1853,1689,5,2,10,-10,1863,1679,15,42,1,-5,16,37,20,0,164
243,May 19 1996,World Cup qualifier in Barbados,Barbados,Dominica,1321,1191,1,0,8,-8,1329,1183,118,162,3,-3,121,159,40,100,230
244,May 19 1996,Friendly in The Gambia,Gambia,Guinea,1313,1324,1,1,-3,3,1310,1327,127,122,0,0,127,122,20,100,89
245,May 19 1996,World Cup qualifier in Saint Lucia,Saint Lucia,Saint Kitts and Nevis,1224,1196,0,1,-27,27,1197,1223,161,143,-6,6,155,149,40,100,128
246,May 19 1996,Friendly in Zambia,Zambia,Tanzania,1686,1413,1,0,2,-2,1688,1411,31,106,1,0,32,106,20,100,373
247,May 21 1996,Friendly in Slovenia,Slovenia,United Arab Emirates,1589,1556,2,2,-4,4,1585,1560,59,64,-1,1,58,65,20,100,133
248,May 21 1996,Friendly in Zambia,Zambia,Tanzania,1688,1411,0,0,-8,8,1680,1419,38,104,-3,1,35,105,20,100,377
249,May 22 1996,Friendly in Brazil,Brazil,Croatia,2071,1899,1,1,-7,7,2064,1906,1,11,0,0,1,11,20,100,272
250,May 23 1996,Friendly in China,China,England,1622,1876,0,3,-10,10,1612,1886,54,13,-4,0,50,13,20,100,-154
251,May 23 1996,Friendly in Kuwait,Kuwait,Syria,1513,1430,3,1,8,-8,1521,1422,74,108,0,-5,74,103,20,100,183
252,May 23 1996,Friendly tournament in Japan,Mexico,Yugoslavia,1863,1948,0,0,4,-4,1867,1944,14,7,1,0,15,7,30,0,-85
253,May 24 1996,Caribbean Cup in Trinidad and Tobago,Trinidad and Tobago,Jamaica,1512,1522,1,0,15,-15,1527,1507,71,79,2,-3,73,76,30,0,-10
254,May 25 1996,Caribbean Cup in Trinidad and Tobago,Cuba,St Vincent & Grenadines,1541,1322,2,0,13,-13,1554,1309,66,130,2,-3,68,127,40,0,219
255,May 25 1996,Caribbean Cup in Trinidad and Tobago,Martinique,Haiti,1490,1353,1,0,12,-12,1502,1341,74,119,4,-1,78,118,40,0,137
256,May 25 1996,Friendly in Mauritius,Mauritius,Madagascar,1181,1497,0,0,6,-6,1187,1491,153,84,4,-2,157,82,20,100,-216
257,May 25 1996,Friendly in Qatar,Qatar,Russia,1428,1925,2,5,-3,3,1425,1928,101,8,0,0,101,8,20,100,-397
258,May 25 1996,Friendly in Uganda,Uganda,Kenya,1410,1444,1,1,-2,2,1408,1446,107,94,0,0,107,94,20,100,66
259,May 26 1996,Friendly in Chile,Chile,Bolivia,1717,1680,2,0,9,-9,1726,1671,29,39,1,-2,30,37,20,100,137
260,May 26 1996,Friendly in Gabon,Gabon,Ivory Coast,1510,1587,0,1,-11,11,1499,1598,85,55,-5,1,80,56,20,100,23
261,May 26 1996,Friendly in Ghana,Ghana,Egypt,1647,1600,0,2,-21,21,1626,1621,48,39,-3,8,45,47,20,100,147
262,May 26 1996,Caribbean Cup in Trinidad and Tobago,Jamaica,Saint Kitts and Nevis,1507,1223,4,1,11,-11,1518,1212,74,151,1,-1,75,150,40,0,284
263,May 26 1996,Friendly tournament in Japan,Japan,Yugoslavia,1685,1944,1,0,21,-21,1706,1923,31,9,1,-1,32,8,30,100,-159
264,May 26 1996,Friendly in Malawi,Malawi,Mozambique,1430,1416,1,0,7,-7,1437,1409,96,104,1,1,97,105,20,100,114
265,May 26 1996,Friendly in Oman,Oman,Algeria,1269,1606,0,1,-4,4,1265,1610,136,55,0,-1,136,54,20,100,-237
266,May 26 1996,Caribbean Cup in Trinidad and Tobago,Trinidad and Tobago,Suriname,1527,1269,3,0,8,-8,1535,1261,71,138,1,-1,72,137,40,100,358
267,May 26 1996,Friendly in Tunisia,Tunisia,Senegal,1609,1469,2,0,6,-6,1615,1463,48,88,2,-1,50,87,20,100,240
268,May 26 1996,Asian Cup qualifier in Turkmenistan,Turkmenistan,Lebanon,1436,1343,0,1,-30,30,1406,1373,115,111,-9,3,106,114,40,100,193
269,May 26 1996,Friendly in Uganda,Uganda,Kenya,1408,1446,1,2,-12,12,1396,1458,107,86,0,4,107,90,20,100,62
270,May 26 1996,Friendly in the United States,United States,Scotland,1730,1783,2,1,9,-9,1739,1774,25,24,2,0,27,24,20,100,47
271,May 27 1996,Friendly in Belarus,Belarus,Azerbaijan,1462,1447,2,2,-3,3,1459,1450,90,92,-1,1,89,93,20,100,115
272,May 27 1996,Caribbean Cup in Trinidad and Tobago,Cuba,Martinique,1554,1502,1,0,17,-17,1571,1485,56,93,6,-8,62,85,40,0,52
273,May 27 1996,Caribbean Cup in Trinidad and Tobago,Haiti,St Vincent & Grenadines,1341,1309,2,2,-2,2,1339,1311,118,125,0,1,118,126,40,0,32
274,May 28 1996,Friendly in Bulgaria,Bulgaria,Macedonia,1828,1545,3,0,3,-3,1831,1542,20,70,0,0,20,70,20,100,383
275,May 28 1996,Friendly in Oman,Oman,Algeria,1265,1610,0,1,-4,4,1261,1614,138,50,-1,2,137,52,20,100,-245
276,May 28 1996,Caribbean Cup in Trinidad and Tobago,Suriname,Jamaica,1261,1518,3,1,49,-49,1310,1469,117,95,10,-10,127,85,40,0,-257
277,May 28 1996,Caribbean Cup in Trinidad and Tobago,Trinidad and Tobago,Saint Kitts and Nevis,1535,1212,5,1,6,-6,1541,1206,70,154,1,-2,71,152,40,100,423
278,May 29 1996,Friendly in Austria,Austria,Czechia,1683,1908,1,0,13,-13,1696,1895,32,13,1,-2,33,11,20,100,-125
279,May 29 1996,Friendly in the United States,Colombia,Scotland,1866,1774,1,0,7,-7,1873,1767,12,26,2,-1,14,25,20,0,92
280,May 29 1996,Caribbean Cup in Trinidad and Tobago,Cuba,Haiti,1571,1339,0,0,-12,12,1559,1351,68,118,-3,0,65,118,40,0,232
281,May 29 1996,Friendly in Estonia,Estonia,Turkey,1091,1762,0,0,9,-9,1100,1753,172,26,1,0,173,26,20,100,-571
282,May 29 1996,Friendly in France,France,Finland,1975,1501,2,0,1,-1,1976,1500,5,79,0,-1,5,78,20,100,574
283,May 29 1996,Friendly in Ireland,Ireland,Portugal,1720,1852,0,1,-9,9,1711,1861,33,14,-1,2,32,16,20,100,-32
284,May 29 1996,Friendly in Italy,Italy,Belgium,1990,1768,2,2,-7,7,1983,1775,5,23,-1,1,4,24,20,100,322
285,May 29 1996,Friendly tournament in Japan,Japan,Mexico,1706,1867,3,2,18,-18,1724,1849,30,21,1,-3,31,18,30,100,-61
286,May 29 1996,Caribbean Cup in Trinidad and Tobago,Martinique,St Vincent & Grenadines,1485,1311,3,0,19,-19,1504,1292,68,136,8,-5,76,131,40,0,174
287,May 29 1996,Friendly in the Netherlands,Netherlands,China,1907,1612,2,0,3,-3,1910,1609,8,55,1,-1,9,54,20,100,395
288,May 29 1996,Friendly in Northern Ireland,Northern Ireland,Germany,1632,2056,1,1,7,-7,1639,2049,41,2,1,0,42,2,20,100,-324
289,May 29 1996,Friendly in Russia,Russia,United Arab Emirates,1928,1560,1,0,1,-1,1929,1559,7,64,0,1,7,65,20,100,468
290,May 30 1996,Caribbean Cup in Trinidad and Tobago,Saint Kitts and Nevis,Suriname,1206,1310,1,1,6,-6,1212,1304,148,130,2,-2,150,128,40,0,-104
291,May 31 1996,World Cup qualifier in Mauritania,Mauritania,Burkina Faso,1258,1365,0,0,0,0,1258,1365,139,117,0,0,139,117,20,100,-7
292,Jun 1 1996,World Cup qualifier in The Gambia,Gambia,Liberia,1310,1393,2,1,19,-19,1329,1374,116,114,5,-3,121,111,30,0,-83
293,Jun 1 1996,Friendly in Germany,Germany,France,2049,1976,0,1,-15,15,2034,1991,2,1,0,2,2,3,20,100,173
294,Jun 1 1996,World Cup qualifier in Guinea-Bissau,Guinea-Bissau,Guinea,1231,1327,3,2,20,-20,1251,1307,137,130,4,-4,141,126,40,100,4
295,Jun 1 1996,Friendly in Hungary,Hungary,Italy,1581,1983,0,2,-4,4,1577,1987,61,4,-1,0,60,4,20,100,-302
296,Jun 1 1996,World Cup qualifier in Iceland,Iceland,Macedonia,1562,1542,1,1,-7,7,1555,1549,70,70,-3,0,67,70,40,100,120
297,Jun 1 1996,World Cup qualifier in Malawi,Malawi,South Africa,1437,1737,0,1,-10,10,1427,1747,103,25,-3,2,100,27,40,100,-200
298,Jun 1 1996,World Cup qualifier in Namibia,Namibia,Mozambique,1160,1409,2,0,42,-42,1202,1367,143,123,10,-9,153,114,40,100,-149
299,Jun 1 1996,Friendly in Qatar,Qatar,Iran,1425,1564,0,1,-9,9,1416,1573,110,62,-5,0,105,62,20,100,-39
300,Jun 1 1996,Friendly in Romania,Romania,Moldova,1892,1467,3,1,1,-1,1893,1466,12,88,0,-1,12,87,20,100,525
301,Jun 1 1996,World Cup qualifier in Sudan,Sudan,Zambia,1393,1680,2,0,45,-45,1438,1635,84,51,12,-8,96,43,40,100,-187
302,Jun 1 1996,World Cup qualifier in Sweden,Sweden,Belarus,1871,1459,5,1,4,-4,1875,1455,13,95,1,-3,14,92,40,100,512
303,Jun 1 1996,Friendly in Switzerland,Switzerland,Czechia,1813,1895,1,2,-11,11,1802,1906,23,9,0,1,23,10,20,100,18
304,Jun 1 1996,World Cup qualifier in Uganda,Uganda,Angola,1396,1443,0,2,-35,35,1361,1478,127,75,-10,10,117,85,40,100,53
305,Jun 2 1996,World Cup qualifier in Belize,Belize,Panama,1107,1295,1,2,-15,15,1092,1310,178,124,-4,3,174,127,40,100,-88
306,Jun 2 1996,Friendly in Bulgaria,Bulgaria,United Arab Emirates,1831,1559,4,1,4,-4,1835,1555,16,68,2,-2,18,66,20,100,372
307,Jun 2 1996,World Cup qualifier in Burundi,Burundi,Sierra Leone,1367,1490,1,0,21,-21,1388,1469,106,88,4,-3,110,85,40,100,-23
308,Jun 2 1996,World Cup qualifier in Congo,Congo,Ivory Coast,1368,1598,2,0,41,-41,1409,1557,99,72,7,-8,106,64,40,100,-130
309,Jun 2 1996,Friendly in Denmark,Denmark,Ghana,1967,1626,1,0,1,-1,1968,1625,6,45,0,0,6,45,20,100,441
310,Jun 2 1996,World Cup qualifier in Ecuador,Ecuador,Argentina,1687,1855,2,0,36,-36,1723,1819,28,25,3,-4,31,21,40,100,-68
311,Jun 2 1996,Friendly in Finland,Finland,Turkey,1500,1753,1,2,-6,6,1494,1759,82,28,-2,-1,80,27,20,100,-153
312,Jun 2 1996,Friendly in Ireland,Ireland,Croatia,1711,1906,2,2,3,-3,1714,1903,32,12,0,-1,32,11,20,100,-95
313,Jun 2 1996,World Cup qualifier in Kenya,Kenya,Algeria,1458,1614,3,1,35,-35,1493,1579,72,64,9,-6,81,58,40,100,-56
314,Jun 2 1996,World Cup qualifier in Madagascar,Madagascar,Zimbabwe,1491,1488,1,2,-26,26,1465,1514,95,68,-7,8,88,76,40,100,103
315,Jun 2 1996,World Cup qualifier in Mauritius,Mauritius,Zaire,1187,1507,1,5,-16,16,1171,1523,168,73,-5,1,163,74,40,100,-220
316,Jun 2 1996,World Cup qualifier in Norway,Norway,Azerbaijan,1816,1450,5,0,5,-5,1821,1445,16,94,3,0,19,94,40,100,466
317,Jun 2 1996,World Cup qualifier in Peru,Peru,Colombia,1533,1873,1,1,12,-12,1545,1861,71,15,1,0,72,15,40,100,-240
318,Jun 2 1996,Friendly in Russia,Russia,Poland,1929,1664,2,0,3,-3,1932,1661,7,39,0,0,7,39,20,100,365
319,Jun 2 1996,World Cup qualifier in Rwanda,Rwanda,Tunisia,1091,1615,1,3,-5,5,1086,1620,175,46,0,2,175,48,40,100,-424
320,Jun 2 1996,World Cup qualifier in San Marino,San Marino,Wales,962,1616,0,5,-3,3,959,1619,193,49,-1,0,192,49,40,100,-554
321,Jun 2 1996,World Cup qualifier in Swaziland,Swaziland,Gabon,1223,1499,0,1,-11,11,1212,1510,149,75,0,2,149,77,40,100,-176
322,Jun 2 1996,World Cup qualifier in Togo,Togo,Senegal,1302,1463,2,1,23,-23,1325,1440,117,102,6,-7,123,95,40,100,-61
323,Jun 2 1996,Caribbean Cup in Trinidad and Tobago,Trinidad and Tobago,Martinique,1541,1504,2,1,12,-12,1553,1492,67,88,2,-6,69,82,40,100,137
324,Jun 2 1996,World Cup qualifier in Uruguay,Uruguay,Paraguay,1843,1739,0,2,-46,46,1797,1785,27,20,-4,4,23,24,40,100,204
325,Jun 2 1996,World Cup qualifier in Venezuela,Venezuela,Chile,1330,1726,1,1,14,-14,1344,1712,118,36,1,-3,119,33,40,100,-296
326,Jun 2 1996,World Cup qualifier in Yugoslavia,Yugoslavia,Malta,1923,1305,6,0,1,-1,1924,1304,8,131,0,-2,8,129,20,0,618
327,Jun 3 1996,Caribbean Cup in Trinidad and Tobago,Cuba,Suriname,1559,1304,4,0,14,-14,1573,1290,59,133,2,-2,61,131,40,0,255
328,Jun 3 1996,Friendly in Oman,Oman,Bahrain,1261,1429,3,0,21,-21,1282,1408,131,114,3,-8,134,106,20,100,-68
329,Jun 4 1996,Friendly in Germany,Germany,Liechtenstein,2034,1097,9,1,0,0,2034,1097,2,173,0,0,2,173,20,0,937
330,Jun 4 1996,Friendly in the Netherlands,Netherlands,Ireland,1910,1714,3,1,5,-5,1915,1709,9,34,0,-1,9,33,20,100,296
331,Jun 5 1996,Friendly in Canada,Canada,Costa Rica,1619,1557,0,1,-14,14,1605,1571,57,62,-4,1,53,63,20,100,162
332,Jun 5 1996,Friendly in France,France,Armenia,1991,1275,2,0,0,0,1991,1275,3,136,0,0,3,136,20,0,716
333,Jun 5 1996,Friendly in Iceland,Iceland,Cyprus,1555,1387,2,1,4,-4,1559,1383,64,111,1,0,65,111,20,100,268
334,Jun 5 1996,Caribbean Cup in Trinidad and Tobago,Martinique,Suriname,1492,1290,1,1,-10,10,1482,1300,84,129,-1,1,83,130,40,0,202
335,Jun 7 1996,Caribbean Cup in Trinidad and Tobago,Trinidad and Tobago,Cuba,1553,1573,2,0,23,-23,1576,1550,51,77,9,-8,60,69,40,100,80
336,Jun 8 1996,European Championship in England,England,Switzerland,1886,1802,1,1,-12,12,1874,1814,15,22,-1,0,14,22,50,100,184
337,Jun 8 1996,US Cup in the United States,Mexico,Bolivia,1849,1671,1,0,8,-8,1857,1663,17,40,0,-2,17,38,30,0,178
338,Jun 8 1996,World Cup qualifier in Tanzania,Tanzania,Ghana,1419,1625,0,0,6,-6,1425,1619,97,51,3,-3,100,48,40,100,-106
339,Jun 9 1996,European Championship in England,Bulgaria,Spain,1835,1987,1,1,10,-10,1845,1977,18,6,0,-1,18,5,50,0,-152
340,Jun 9 1996,European Championship in England,Denmark,Portugal,1968,1861,1,1,-7,7,1961,1868,6,15,0,0,6,15,50,0,107
341,Jun 9 1996,European Championship in England,Germany,Czechia,2034,1906,2,0,24,-24,2058,1882,2,14,0,-2,2,12,50,0,128
342,Jun 9 1996,Friendly in Ivory Coast,Ivory Coast,Burkina Faso,1557,1365,1,1,-7,7,1550,1372,70,112,-2,2,68,114,20,100,292
343,Jun 9 1996,Asian Cup qualifier in Lebanon,Lebanon,Kuwait,1373,1521,3,5,-26,26,1347,1547,124,69,-5,3,119,72,40,100,-48
344,Jun 9 1996,Friendly in Nigeria,Nigeria,Togo,1821,1325,1,3,-29,29,1792,1354,27,111,-4,6,23,117,20,100,596
345,Jun 9 1996,World Cup qualifier in Panama,Panama,Belize,1310,1092,4,1,10,-10,1320,1082,123,178,2,-2,125,176,40,100,318
346,Jun 9 1996,US Cup in the United States,United States,Ireland,1739,1709,2,1,10,-10,1749,1699,27,33,1,0,28,33,30,100,130
347,Jun 10 1996,World Cup qualifier in Trinidad and Tobago,Cuba,Haiti,1550,1351,6,1,19,-19,1569,1332,60,124,4,-3,64,121,40,0,199
348,Jun 10 1996,European Championship in England,France,Romania,1991,1893,1,0,18,-18,2009,1875,3,13,0,-1,3,12,50,0,98
349,Jun 10 1996,Asian Cup qualifier in Iran,Iran,Nepal,1573,877,8,0,1,-1,1574,876,62,199,0,0,62,199,20,0,696
350,Jun 10 1996,European Championship in England,Netherlands,Scotland,1915,1767,0,0,-10,10,1905,1777,9,24,0,1,9,25,50,0,148
351,Jun 10 1996,Asian Cup qualifier in Iran,Oman,Sri Lanka,1282,918,3,0,8,-8,1290,910,130,196,2,0,132,196,40,0,364
352,Jun 11 1996,European Championship in England,Croatia,Turkey,1903,1759,1,0,15,-15,1918,1744,6,31,2,-2,8,29,50,0,144
353,Jun 11 1996,European Championship in England,Italy,Russia,1987,1932,2,1,21,-21,2008,1911,4,11,0,-2,4,9,50,0,55
354,Jun 12 1996,Asian Cup qualifier in Iran,Iran,Sri Lanka,1574,910,7,0,1,-1,1575,909,60,196,1,0,61,196,20,0,664
355,Jun 12 1996,US Cup in the United States,Ireland,Mexico,1699,1857,2,2,6,-6,1705,1851,33,17,0,0,33,17,30,0,-158
356,Jun 12 1996,Asian Cup qualifier in Iran,Oman,Nepal,1290,876,7,0,8,-8,1298,868,130,203,1,-2,131,201,40,0,414
357,Jun 12 1996,Friendly in Tanzania,Tanzania,Sudan,1425,1438,0,0,-2,2,1423,1440,102,94,-1,1,101,95,20,100,87
358,Jun 12 1996,US Cup in the United States,United States,Bolivia,1749,1663,0,2,-34,34,1715,1697,35,30,-4,4,31,34,30,100,186
359,Jun 13 1996,Friendly in Barbados,Barbados,Trinidad and Tobago,1329,1576,0,4,-11,11,1318,1587,128,52,-3,4,125,56,20,100,-147
360,Jun 13 1996,European Championship in England,Bulgaria,Romania,1845,1875,1,0,27,-27,1872,1848,10,24,4,-6,14,18,50,0,-30
361,Jun 13 1996,European Championship in England,Netherlands,Switzerland,1905,1814,2,0,28,-28,1933,1786,4,25,3,-2,7,23,50,0,91
362,Jun 14 1996,World Cup qualifier in Algeria,Algeria,Kenya,1579,1493,1,0,10,-10,1589,1483,53,83,3,-1,56,82,40,100,186
363,Jun 14 1996,European Championship in England,Czechia,Italy,1882,2008,2,1,34,-34,1916,1974,9,6,1,-1,10,5,50,0,-126
364,Jun 14 1996,Asian Cup qualifier in Iran,Iran,Oman,1575,1298,2,0,6,-6,1581,1292,57,131,2,0,59,131,40,100,377
365,Jun 14 1996,Asian Cup qualifier in Kazakhstan,Kazakhstan,Qatar,1564,1416,1,0,8,-8,1572,1408,61,106,2,-1,63,105,40,100,248
366,Jun 14 1996,European Championship in England,Portugal,Turkey,1868,1744,1,0,16,-16,1884,1728,9,28,3,0,12,28,50,0,124
367,Jun 14 1996,Asian Cup qualifier in Iran,Sri Lanka,Nepal,909,868,3,1,26,-26,935,842,194,205,1,-2,195,203,40,0,41
368,Jun 15 1996,World Cup qualifier in the Dominican Republic,Dominican Republic,Trinidad and Tobago,1112,1587,1,4,-7,7,1105,1594,169,55,0,1,169,56,40,100,-375
369,Jun 15 1996,European Championship in England,England,Scotland,1874,1777,2,0,18,-18,1892,1759,10,27,2,-1,12,26,50,100,197
370,Jun 15 1996,European Championship in England,France,Spain,2009,1977,1,1,-2,2,2007,1979,3,4,0,0,3,4,40,0,32
371,Jun 15 1996,US Cup in the United States,Ireland,Bolivia,1705,1697,3,0,26,-26,1731,1671,23,38,5,-2,28,36,30,0,8
372,Jun 15 1996,World Cup qualifier in Senegal,Senegal,Togo,1440,1354,1,1,-10,10,1430,1364,99,115,-2,1,97,116,40,100,186
373,Jun 15 1996,World Cup qualifier in South Africa,South Africa,Malawi,1747,1427,3,0,6,-6,1753,1421,27,105,0,-3,27,102,40,100,420
374,Jun 16 1996,World Cup qualifier in Angola,Angola,Uganda,1478,1361,3,1,13,-13,1491,1348,78,117,3,0,81,117,40,100,217
375,Jun 16 1996,World Cup qualifier in Burkina Faso,Burkina Faso,Mauritania,1372,1258,2,0,14,-14,1386,1244,108,147,3,-4,111,143,40,100,214
376,Jun 16 1996,European Championship in England,Croatia,Denmark,1918,1961,3,0,49,-49,1967,1912,3,14,3,-4,6,10,50,0,-43
377,Jun 16 1996,World Cup qualifier in Gabon,Gabon,Swaziland,1510,1212,2,0,6,-6,1516,1206,75,157,1,-4,76,153,40,100,398
378,Jun 16 1996,European Championship in England,Germany,Russia,2058,1911,3,0,26,-26,2084,1885,0,13,1,-1,1,12,50,0,147
379,Jun 16 1996,World Cup qualifier in Guinea,Guinea,Guinea-Bissau,1307,1251,3,1,17,-17,1324,1234,120,149,4,-4,124,145,40,100,156
380,Jun 16 1996,World Cup qualifier in Ivory Coast,Ivory Coast,Congo,1550,1409,1,1,-12,12,1538,1421,77,100,-4,2,73,102,40,100,241
381,Jun 16 1996,World Cup qualifier in Mozambique,Mozambique,Namibia,1367,1202,1,1,-13,13,1354,1215,117,145,-1,4,116,149,40,100,265
382,Jun 16 1996,World Cup qualifier in Sierra Leone,Sierra Leone,Burundi,1469,1388,0,1,-30,30,1439,1418,103,100,-9,5,94,105,40,100,181
383,Jun 16 1996,World Cup qualifier in Tunisia,Tunisia,Rwanda,1620,1086,2,0,2,-2,1622,1084,43,176,2,-1,45,175,30,0,534
384,Jun 16 1996,US Cup in the United States,United States,Mexico,1715,1851,2,2,2,-2,1717,1849,32,17,0,0,32,17,30,100,-36
385,Jun 16 1996,World Cup qualifier in Zaire,Zaire,Mauritius,1523,1171,2,0,4,-4,1527,1167,75,163,0,0,75,163,40,100,452
386,Jun 16 1996,World Cup qualifier in Zambia,Zambia,Sudan,1635,1440,3,0,11,-11,1646,1429,39,99,2,-2,41,97,40,100,295
387,Jun 16 1996,World Cup qualifier in Zimbabwe,Zimbabwe,Madagascar,1514,1465,2,2,-8,8,1506,1473,78,82,-1,3,77,85,40,100,149
388,Jun 17 1996,World Cup qualifier in Ghana,Ghana,Tanzania,1619,1423,2,1,6,-6,1625,1417,42,110,3,-5,45,105,40,100,296
389,Jun 17 1996,Asian Cup qualifier in Oman,Iran,Sri Lanka,1581,935,4,0,2,-2,1583,933,59,195,0,0,59,195,40,0,646
390,Jun 17 1996,Asian Cup qualifier in Oman,Oman,Nepal,1292,842,2,1,2,-2,1294,840,131,203,0,0,131,203,30,0,450
391,Jun 18 1996,European Championship in England,England,Netherlands,1892,1933,4,1,36,-36,1928,1897,3,15,4,-4,7,11,50,100,59
392,Jun 18 1996,European Championship in England,France,Bulgaria,2007,1872,3,1,24,-24,2031,1848,3,19,0,-2,3,17,50,0,135
393,Jun 18 1996,European Championship in England,Scotland,Switzerland,1759,1786,1,0,27,-27,1786,1759,20,29,3,-3,23,26,50,0,-27
394,Jun 18 1996,European Championship in England,Spain,Romania,1979,1848,2,1,16,-16,1995,1832,4,18,0,0,4,18,50,0,131
395,Jun 19 1996,European Championship in England,Czechia,Russia,1916,1885,3,3,-2,2,1914,1887,11,14,-1,-1,10,13,40,0,31
396,Jun 19 1996,European Championship in England,Denmark,Turkey,1912,1728,3,0,23,-23,1935,1705,4,37,3,-4,7,33,50,0,184
397,Jun 19 1996,European Championship in England,Germany,Italy,2084,1974,0,0,-8,8,2076,1982,1,5,0,0,1,5,30,100,210
398,Jun 19 1996,Asian Cup qualifier in Oman,Iran,Nepal,1583,840,4,0,1,-1,1584,839,59,203,0,0,59,203,20,0,743
399,Jun 19 1996,Asian Cup qualifier in Oman,Oman,Sri Lanka,1294,933,10,0,7,-7,1301,926,129,197,1,-1,130,196,40,100,461
400,Jun 19 1996,European Championship in England,Portugal,Croatia,1884,1967,3,0,54,-54,1938,1913,-1,16,7,-5,6,11,50,0,-83
401,Jun 19 1996,Asian Cup qualifier in Uzbekistan,Uzbekistan,Tajikistan,1665,1438,5,0,11,-11,1676,1427,34,101,2,-3,36,98,40,100,327
402,Jun 20 1996,Asian Cup qualifier in Kuwait,Kuwait,Lebanon,1547,1347,0,0,-14,14,1533,1361,77,114,-3,2,74,116,40,100,300
403,Jun 20 1996,Friendly in Peru,Peru,Armenia,1545,1275,4,0,4,-4,1549,1271,68,138,2,-1,70,137,20,100,370
404,Jun 21 1996,Asian Cup qualifier in Oman,Oman,Iran,1301,1584,1,2,-10,10,1291,1594,134,53,-2,3,132,56,40,100,-183
405,Jun 21 1996,Asian Cup qualifier in Oman,Sri Lanka,Nepal,926,839,2,0,23,-23,949,816,192,205,2,-1,194,204,40,0,87
406,Jun 21 1996,Asian Cup qualifier in Syria,Syria,Kazakhstan,1422,1572,2,0,34,-34,1456,1538,78,79,11,-8,89,71,40,100,-50
407,Jun 22 1996,European Championship in England,England,Spain,1928,1995,0,0,-2,2,1926,1997,8,4,0,0,8,4,40,100,33
408,Jun 22 1996,European Championship in England,France,Netherlands,2031,1897,0,0,-9,9,2022,1906,3,12,0,0,3,12,30,100,234
409,Jun 22 1996,Friendly in Honduras,Honduras,Venezuela,1550,1344,1,0,3,-3,1553,1341,68,119,0,0,68,119,20,100,306
410,Jun 23 1996,World Cup qualifier in Barbados,Barbados,Jamaica,1318,1469,0,1,-17,17,1301,1486,130,80,-2,3,128,83,40,100,-51
411,Jun 23 1996,European Championship in England,Czechia,Portugal,1914,1938,1,0,27,-27,1941,1911,2,14,4,-4,6,10,50,0,-24
412,Jun 23 1996,European Championship in England,Germany,Croatia,2076,1913,2,1,14,-14,2090,1899,1,13,0,-1,1,12,50,0,163
413,Jun 23 1996,World Cup qualifier in Ghana,Liberia,Gambia,1374,1329,4,0,33,-33,1407,1296,102,138,6,-8,108,130,40,0,45
414,Jun 23 1996,World Cup qualifier in Saint Kitts and Nevis,Saint Kitts and Nevis,St Vincent & Grenadines,1212,1292,2,2,-1,1,1211,1293,150,131,0,0,150,131,20,100,20
415,Jun 23 1996,World Cup qualifier in Trinidad and Tobago,Trinidad and Tobago,Dominican Republic,1594,1105,8,0,3,-3,1597,1102,54,173,1,-2,55,171,20,0,489
416,Jun 25 1996,Friendly in Paraguay,Paraguay,Armenia,1785,1271,1,2,-19,19,1766,1290,26,129,-1,4,25,133,20,0,514
417,Jun 26 1996,Friendly in Brazil,Brazil,Poland,2064,1661,3,1,2,-2,2066,1659,2,39,0,0,2,39,20,100,503
418,Jun 26 1996,European Championship in England,Czechia,France,1941,2022,0,0,6,-6,1947,2016,6,3,0,0,6,3,50,0,-81
419,Jun 26 1996,European Championship in England,England,Germany,1926,2090,1,1,5,-5,1931,2085,8,1,0,0,8,1,50,100,-64
420,Jun 27 1996,Asian Cup qualifier in Thailand,Singapore,Myanmar,1282,1140,4,0,23,-23,1305,1117,118,172,9,-4,127,168,40,0,142
421,Jun 27 1996,Asian Cup qualifier in Thailand,Thailand,Maldives,1449,769,8,0,1,-1,1450,768,93,207,0,0,93,207,20,0,680
422,Jun 28 1996,Friendly in China,China,New Zealand,1609,1489,2,0,7,-7,1616,1482,48,86,2,-2,50,84,20,100,220
423,Jun 28 1996,Asian Cup qualifier in Qatar,Qatar,Syria,1408,1456,1,0,17,-17,1425,1439,94,99,6,-5,100,94,30,0,-48
424,Jun 29 1996,Asian Cup qualifier in Thailand,Singapore,Maldives,1305,768,2,0,3,-3,1308,765,127,207,0,0,127,207,40,0,537
425,Jun 29 1996,Asian Cup qualifier in Thailand,Thailand,Myanmar,1450,1117,5,1,6,-6,1456,1111,86,168,3,0,89,168,40,100,433
426,Jun 30 1996,Friendly in Ecuador,Ecuador,Armenia,1723,1290,3,0,2,-2,1725,1288,28,134,1,0,29,134,20,100,533
427,Jun 30 1996,European Championship in England,Germany,Czechia,2085,1947,2,1,16,-16,2101,1931,1,8,0,-1,1,7,50,0,138
428,Jun 30 1996,World Cup qualifier in Haiti,Haiti,Cuba,1332,1569,1,1,8,-8,1340,1561,119,64,1,0,120,64,40,100,-137
429,Jun 30 1996,World Cup qualifier in Jamaica,Jamaica,Barbados,1486,1301,2,0,10,-10,1496,1291,78,133,2,-2,80,131,40,100,285
430,Jun 30 1996,World Cup qualifier in St Vincent & Grenadines,St Vincent & Grenadines,Saint Kitts and Nevis,1293,1211,0,0,-10,10,1283,1221,140,148,-4,1,136,149,40,100,182
431,Jul 1 1996,Asian Cup qualifier in Thailand,Myanmar,Maldives,1111,765,3,1,7,-7,1118,758,168,207,0,0,168,207,40,0,346
432,Jul 1 1996,Asian Cup qualifier in Thailand,Thailand,Singapore,1456,1308,1,1,-12,12,1444,1320,97,121,-4,3,93,124,40,100,248
433,Jul 4 1996,Asian Cup qualifier in Singapore,Singapore,Myanmar,1320,1118,2,2,-14,14,1306,1132,130,164,-3,2,127,166,40,100,302
434,Jul 4 1996,Asian Cup qualifier in Singapore,Thailand,Maldives,1444,758,8,0,2,-2,1446,756,91,207,1,0,92,207,40,0,686
435,Jul 5 1996,Asian Cup qualifier in Qatar,Qatar,Kazakhstan,1425,1538,3,0,36,-36,1461,1502,78,83,11,-6,89,77,40,100,-13
436,Jul 6 1996,World Cup qualifier in Chile,Chile,Ecuador,1712,1725,4,1,26,-26,1738,1699,24,37,4,-4,28,33,40,100,87
437,Jul 6 1996,Friendly in Malawi,Malawi,Tanzania,1421,1417,3,2,7,-7,1428,1410,98,106,2,0,100,106,20,100,104
438,Jul 7 1996,World Cup qualifier in Bolivia,Bolivia,Venezuela,1671,1341,6,1,6,-6,1677,1335,35,123,1,-2,36,121,40,100,430
439,Jul 7 1996,World Cup qualifier in Colombia,Colombia,Uruguay,1861,1797,3,1,17,-17,1878,1780,13,25,1,-2,14,23,40,100,164
440,Jul 7 1996,Baltic Cup in Estonia,Estonia,Latvia,1100,1425,1,1,9,-9,1109,1416,166,108,3,-3,169,105,30,100,-225
441,Jul 7 1996,World Cup qualifier in Peru,Peru,Argentina,1549,1819,0,0,9,-9,1558,1810,63,20,3,0,66,20,40,100,-170
442,Jul 7 1996,Asian Cup qualifier in Singapore,Singapore,Maldives,1306,756,5,2,2,-2,1308,754,127,207,0,0,127,207,30,0,550
443,Jul 7 1996,Asian Cup qualifier in Singapore,Thailand,Myanmar,1446,1132,7,1,12,-12,1458,1120,87,170,3,-2,90,168,40,0,314
444,Jul 8 1996,Baltic Cup in Estonia,Lithuania,Latvia,1429,1416,2,1,14,-14,1443,1402,92,113,3,-4,95,109,30,0,13
445,Jul 8 1996,Friendly in Malawi,Malawi,Tanzania,1428,1410,1,0,7,-7,1435,1403,96,110,2,-2,98,108,20,100,118
446,Jul 9 1996,Baltic Cup in Estonia,Estonia,Lithuania,1109,1443,1,1,9,-9,1118,1434,169,101,0,-3,169,98,30,100,-234
447,Jul 9 1996,Asian Cup qualifier in Singapore,Myanmar,Maldives,1120,754,4,1,8,-8,1128,746,164,209,2,-1,166,208,40,0,366
448,Jul 9 1996,Asian Cup qualifier in Singapore,Singapore,Thailand,1308,1458,2,2,3,-3,1311,1455,127,92,0,-1,127,91,40,100,-50
449,Jul 10 1996,Friendly in Malawi,Malawi,Tanzania,1435,1403,1,1,-4,4,1431,1407,99,104,-1,2,98,106,20,100,132
450,Jul 12 1996,Asian Cup qualifier in Kazakhstan,Kazakhstan,Syria,1502,1439,0,1,-29,29,1473,1468,93,79,-8,8,85,87,40,100,163
451,Jul 17 1996,Friendly in China,China,Uruguay,1616,1780,1,1,2,-2,1618,1778,50,23,0,0,50,23,20,100,-64
452,Jul 19 1996,Asian Cup qualifier in Syria,Syria,Qatar,1468,1461,3,1,21,-21,1489,1440,77,100,5,-5,82,95,40,100,107
453,Jul 21 1996,Friendly in Panama,Panama,Venezuela,1320,1335,0,2,-19,19,1301,1354,132,113,-4,4,128,117,20,100,85
454,Jul 24 1996,Friendly in Honduras,Honduras,Panama,1553,1301,1,1,-8,8,1545,1309,71,126,-1,1,70,127,20,100,352
455,Jul 26 1996,Friendly in Paraguay,Paraguay,Bolivia,1766,1677,2,0,8,-8,1774,1669,25,38,0,-1,25,37,20,100,189
456,Jul 28 1996,Friendly in Honduras,Honduras,Trinidad and Tobago,1545,1597,0,0,-1,1,1544,1598,70,55,0,0,70,55,20,100,48
457,Jul 28 1996,Friendly in Jamaica,Jamaica,Panama,1496,1309,0,0,-7,7,1489,1316,83,125,-2,1,81,126,20,100,287
458,Jul 30 1996,Friendly in Panama,Panama,Trinidad and Tobago,1316,1598,1,0,15,-15,1331,1583,118,63,4,-4,122,59,20,100,-182
459,Jul 31 1996,Friendly in Belarus,Belarus,Lithuania,1455,1434,2,2,-3,3,1452,1437,93,97,-1,0,92,97,20,100,121
460,Aug 4 1996,Friendly in Costa Rica,Costa Rica,Honduras,1571,1544,1,1,-4,4,1567,1548,63,70,0,0,63,70,20,100,127
461,Aug 4 1996,Friendly in Guatemala,Guatemala,Panama,1462,1331,1,0,4,-4,1466,1327,87,122,1,0,88,122,20,100,231
462,Aug 4 1996,Asian Cup qualifier in Vietnam,Vietnam,Taiwan,1211,1020,4,1,11,-11,1222,1009,147,190,2,-1,149,189,40,100,291
463,Aug 5 1996,Asian Cup qualifier in Vietnam,South Korea,Guam,1615,663,9,0,0,0,1615,663,51,213,0,0,51,213,20,0,952
464,Aug 7 1996,Friendly in Panama,Panama,Honduras,1327,1548,2,1,13,-13,1340,1535,118,74,2,-2,120,72,20,100,-121
465,Aug 7 1996,Asian Cup qualifier in Vietnam,Vietnam,Guam,1222,663,9,0,2,-2,1224,661,149,213,0,0,149,213,20,0,559
466,Aug 8 1996,Friendly in China,China,Paraguay,1618,1774,0,2,-13,13,1605,1787,54,19,-2,3,52,22,20,100,-56
467,Aug 8 1996,Asian Cup qualifier in Vietnam,South Korea,Taiwan,1615,1009,4,0,2,-2,1617,1007,49,189,1,0,50,189,30,0,606
468,Aug 9 1996,Asian Cup qualifier in Jordan,Jordan,Pakistan,1317,871,4,0,3,-3,1320,868,125,201,0,-1,125,200,20,0,446
469,Aug 10 1996,Asian Cup qualifier in Vietnam,Taiwan,Guam,1007,661,9,2,11,-11,1018,650,187,213,1,0,188,213,40,0,346
470,Aug 11 1996,African Nations Cup qualifier in Benin,Benin,Mauritania,1138,1244,4,1,36,-36,1174,1208,162,161,1,-9,163,152,40,100,-6
471,Aug 11 1996,African Nations Cup qualifier in Botswana,Botswana,Namibia,1023,1215,0,0,5,-5,1028,1210,185,149,1,1,186,150,20,0,-192
472,Aug 11 1996,African Nations Cup qualifier in Congo,Congo,Togo,1421,1364,0,0,-8,8,1413,1372,106,115,-2,0,104,115,40,100,157
473,Aug 11 1996,Friendly in Honduras,Honduras,Costa Rica,1535,1567,0,0,-2,2,1533,1569,72,63,0,0,72,63,20,100,68
474,Aug 11 1996,Asian Cup qualifier in Jordan,Jordan,Iraq,1320,1649,0,1,-8,8,1312,1657,127,40,-1,0,126,40,40,100,-229
475,Aug 11 1996,African Nations Cup qualifier in Mauritius,Mauritius,Seychelles,1167,927,1,0,5,-5,1172,922,165,196,-1,0,164,196,40,100,340
476,Aug 11 1996,African Nations Cup qualifier in Uganda,Uganda,Ethiopia,1348,1336,1,1,-6,6,1342,1342,119,116,0,3,119,119,40,100,112
477,Aug 11 1996,Asian Cup qualifier in Vietnam,Vietnam,South Korea,1224,1617,0,4,-12,12,1212,1629,149,40,0,5,149,45,40,100,-293
478,Aug 13 1996,Asian Cup qualifier in Jordan,Iraq,Pakistan,1657,868,3,0,1,-1,1658,867,40,200,0,0,40,200,30,0,789
479,Aug 13 1996,Friendly in Ukraine,Ukraine,Lithuania,1580,1437,5,2,7,-7,1587,1430,56,99,2,-1,58,98,20,100,243
480,Aug 14 1996,Friendly in Greece,Greece,Albania,1631,1456,2,1,3,-3,1634,1453,44,92,0,-1,44,91,20,100,275
481,Aug 14 1996,Friendly in Honduras,Honduras,El Salvador,1533,1538,2,1,7,-7,1540,1531,68,76,2,-3,70,73,20,100,95
482,Aug 14 1996,Friendly in Hungary,Hungary,United Arab Emirates,1577,1555,3,1,10,-10,1587,1545,55,71,3,-2,58,69,20,100,122
483,Aug 14 1996,Friendly in Iceland,Iceland,Malta,1559,1304,2,1,2,-2,1561,1302,63,128,1,0,64,128,20,100,355
484,Aug 14 1996,Friendly in Latvia,Latvia,Finland,1402,1494,0,0,0,0,1402,1494,109,79,0,0,109,79,20,100,8
485,Aug 14 1996,Friendly in Panama,Panama,Guatemala,1340,1466,1,0,11,-11,1351,1455,117,90,2,-1,119,89,20,100,-26
486,Aug 14 1996,Friendly in Peru,Peru,Costa Rica,1558,1569,3,0,13,-13,1571,1556,60,69,3,-3,63,66,20,100,89
487,Aug 14 1996,Friendly in Romania,Romania,Israel,1832,1622,2,0,4,-4,1836,1618,18,53,0,-3,18,50,20,100,310
488,Aug 14 1996,Friendly in Sweden,Sweden,Denmark,1875,1935,0,1,-11,11,1864,1946,15,6,0,0,15,6,20,100,40
489,Aug 14 1996,Friendly in Turkey,Turkey,Moldova,1705,1466,2,0,4,-4,1709,1462,32,88,0,0,32,88,20,100,339
490,Aug 16 1996,Friendly in Ecuador,Ecuador,Costa Rica,1699,1556,1,1,-6,6,1693,1562,35,62,-1,2,34,64,20,100,243
491,Aug 17 1996,Friendly in Rwanda,Rwanda,Uganda,1084,1342,0,0,4,-4,1088,1338,173,124,1,-2,174,122,20,100,-158
492,Aug 18 1996,Friendly in the United States,Guatemala,Honduras,1455,1540,1,1,2,-2,1457,1538,89,70,0,0,89,70,20,0,-85
493,Aug 20 1996,Friendly in Oman,Oman,Mali,1291,1317,1,0,8,-8,1299,1309,129,129,1,-2,130,127,20,100,74
494,Aug 20 1996,Friendly in Togo,Togo,Benin,1372,1174,2,0,5,-5,1377,1169,113,165,1,-1,114,164,20,100,298
495,Aug 20 1996,Friendly in Germany,United Arab Emirates,Belarus,1545,1452,1,0,7,-7,1552,1445,67,94,1,-1,68,93,20,0,93
496,Aug 21 1996,Friendly in El Salvador,El Salvador,Honduras,1531,1538,1,2,-13,13,1518,1551,75,68,-1,1,74,69,20,100,93
497,Aug 22 1996,Friendly in Oman,Oman,Mali,1299,1309,1,1,-3,3,1296,1312,130,123,0,2,130,125,20,100,90
498,Aug 24 1996,Friendly in Panama,Panama,Jamaica,1351,1489,2,0,17,-17,1368,1472,113,93,3,-6,116,87,20,100,-38
499,Aug 24 1996,African Nations Cup qualifier in the Seychelles,Seychelles,Mauritius,922,1172,1,1,8,-8,930,1164,196,165,0,-1,196,164,40,100,-150
500,Aug 25 1996,African Nations Cup qualifier in Ethiopia,Ethiopia,Uganda,1342,1338,1,1,-6,6,1336,1344,124,118,-2,2,122,120,40,100,104
501,Aug 25 1996,Friendly in Honduras,Honduras,Cuba,1551,1561,4,0,14,-14,1565,1547,59,75,5,-5,64,70,20,100,90
502,Aug 25 1996,Friendly in Japan,Japan,Uruguay,1724,1778,5,3,13,-13,1737,1765,28,26,1,-1,29,25,20,100,46
503,Aug 25 1996,African Nations Cup qualifier in Namibia,Namibia,Botswana,1210,1028,6,0,14,-14,1224,1014,146,192,2,-3,148,189,40,100,282
504,Aug 25 1996,African Nations Cup qualifier in Togo,Togo,Congo,1377,1413,1,0,16,-16,1393,1397,106,114,4,-5,110,109,40,100,64
505,Aug 26 1996,Friendly in Costa Rica,Costa Rica,Chile,1562,1738,1,1,2,-2,1564,1736,65,30,0,-1,65,29,20,100,-76
506,Aug 27 1996,Friendly in Guatemala,Guatemala,Jamaica,1457,1472,2,1,8,-8,1465,1464,85,89,2,-1,87,88,20,100,85
507,Aug 27 1996,Friendly in Poland,Poland,Cyprus,1659,1383,2,2,-8,8,1651,1391,41,108,-1,3,40,111,20,100,376
508,Aug 28 1996,Friendly in Honduras,Honduras,Cuba,1565,1547,2,2,-3,3,1562,1550,66,68,-1,1,65,69,20,100,118
509,Aug 28 1996,Friendly in Oman,Oman,Sudan,1296,1429,0,0,1,-1,1297,1428,130,100,0,0,130,100,20,100,-33
510,Aug 28 1996,Friendly in Russia,Russia,Brazil,1887,2066,2,2,2,-2,1889,2064,13,2,0,0,13,2,20,100,-79
511,Aug 29 1996,Friendly in Morocco,Morocco,Zaire,1612,1527,7,0,12,-12,1624,1515,43,77,4,-2,47,75,20,100,185
512,Aug 30 1996,World Cup qualifier in Canada,Canada,Panama,1605,1368,3,1,8,-8,1613,1360,52,118,0,-1,52,117,40,100,337
513,Aug 30 1996,Friendly in Guatemala,Guatemala,Cuba,1465,1550,1,1,0,0,1465,1550,87,69,0,0,87,69,20,100,15
514,Aug 30 1996,African Nations Cup qualifier in Mauritania,Mauritania,Benin,1208,1169,0,0,-8,8,1200,1177,158,161,-3,1,155,162,40,100,139
515,Aug 30 1996,Friendly in the United States,United States,El Salvador,1717,1518,3,1,5,-5,1722,1513,31,77,0,-2,31,75,20,100,299
516,Aug 31 1996,World Cup qualifier in Armenia,Armenia,Portugal,1288,1911,0,0,18,-18,1306,1893,122,14,6,-2,128,12,40,100,-523
517,Aug 31 1996,World Cup qualifier in Austria,Austria,Scotland,1696,1786,0,0,-1,1,1695,1787,33,21,0,1,33,22,40,100,10
518,Aug 31 1996,World Cup qualifier in Azerbaijan,Azerbaijan,Switzerland,1445,1759,1,0,31,-31,1476,1728,77,34,8,-4,85,30,40,100,-214
519,Aug 31 1996,World Cup qualifier in Belarus,Belarus,Estonia,1445,1118,1,0,3,-3,1448,1115,95,169,-1,0,94,169,20,0,327
520,Aug 31 1996,World Cup qualifier in Belgium,Belgium,Turkey,1775,1709,2,1,11,-11,1786,1698,24,32,0,0,24,32,40,100,166
521,Aug 31 1996,World Cup qualifier in the Faroe Islands,Faroe Islands,Slovakia,1183,1679,1,2,-4,4,1179,1683,162,35,-1,0,161,35,40,100,-396
522,Aug 31 1996,Friendly in France,France,Mexico,2016,1849,2,0,5,-5,2021,1844,3,18,0,-1,3,17,20,100,267
523,Aug 31 1996,World Cup qualifier in Liechtenstein,Liechtenstein,Ireland,1097,1731,0,5,-4,4,1093,1735,173,28,0,1,173,29,40,100,-534
524,Aug 31 1996,Friendly in the Netherlands,Netherlands,Brazil,1906,2064,2,2,2,-2,1908,2062,9,2,1,0,10,2,20,100,-58
525,Aug 31 1996,World Cup qualifier in Northern Ireland,Northern Ireland,Ukraine,1639,1587,0,1,-28,28,1611,1615,64,44,-11,7,53,51,40,100,152
526,Aug 31 1996,Friendly in Oman,Oman,Sudan,1297,1428,0,1,-9,9,1288,1437,138,94,-4,3,134,97,20,100,-31
527,Aug 31 1996,World Cup qualifier in Romania,Romania,Lithuania,1836,1430,3,0,4,-4,1840,1426,18,104,0,-3,18,101,40,100,506
528,Aug 31 1996,World Cup qualifier in Wales,Wales,San Marino,1619,959,6,0,1,-1,1620,958,48,192,1,0,49,192,20,0,660
529,Sep 1 1996,World Cup qualifier in Argentina,Argentina,Paraguay,1810,1787,1,1,-7,7,1803,1794,20,20,0,1,20,21,40,100,123
530,Sep 1 1996,World Cup qualifier in Bolivia,Bolivia,Peru,1669,1571,0,0,-10,10,1659,1581,39,57,-1,3,38,60,40,100,198
531,Sep 1 1996,World Cup qualifier in Colombia,Colombia,Chile,1878,1736,4,1,14,-14,1892,1722,12,32,1,-2,13,30,40,100,242
532,Sep 1 1996,World Cup qualifier in Ecuador,Ecuador,Venezuela,1693,1354,1,0,3,-3,1696,1351,32,120,1,-1,33,119,40,100,439
533,Sep 1 1996,World Cup qualifier in Greece,Greece,Bosnia and Herzegovina,1634,1595,3,0,22,-22,1656,1573,37,70,3,-7,40,63,40,100,139
534,Sep 1 1996,World Cup qualifier in Hungary,Hungary,Finland,1587,1494,1,0,10,-10,1597,1484,53,83,3,-2,56,81,40,100,193
535,Sep 1 1996,World Cup qualifier in Israel,Israel,Bulgaria,1618,1848,2,1,27,-27,1645,1821,36,22,7,-3,43,19,40,100,-130
536,Sep 1 1996,World Cup qualifier in Latvia,Latvia,Sweden,1402,1864,1,2,-4,4,1398,1868,108,15,0,0,108,15,40,100,-362
537,Sep 1 1996,World Cup qualifier in Moldova,Moldova,England,1462,1931,0,3,-7,7,1455,1938,90,7,0,0,90,7,40,100,-369
538,Sep 1 1996,Friendly in Norway,Norway,Georgia,1821,1638,1,0,3,-3,1824,1635,17,46,1,-2,18,44,20,100,283
539,Sep 1 1996,World Cup qualifier in Russia,Russia,Cyprus,1889,1391,4,0,2,-2,1891,1389,15,115,-1,-2,14,113,20,0,498
540,Sep 1 1996,World Cup qualifier in Slovenia,Slovenia,Denmark,1585,1946,0,2,-11,11,1574,1957,64,6,-2,0,62,6,40,100,-261
541,Sep 1 1996,World Cup qualifier in Trinidad and Tobago,Trinidad and Tobago,Costa Rica,1583,1564,0,1,-27,27,1556,1591,71,52,-5,6,66,58,40,100,119
542,Sep 2 1996,Southeast Asian Champ in Singapore,Indonesia,Laos,1275,966,5,1,11,-11,1286,955,133,196,2,-3,135,193,40,0,309
543,Sep 2 1996,Southeast Asian Champ in Singapore,Singapore,Malaysia,1311,1248,1,1,-9,9,1302,1257,129,138,-1,1,128,139,40,100,163
544,Sep 2 1996,Southeast Asian Champ in Singapore,Thailand,Philippines,1455,789,5,0,2,-2,1457,787,90,206,0,0,90,206,40,0,666
545,Sep 2 1996,Southeast Asian Champ in Singapore,Vietnam,Cambodia,1212,1123,3,1,22,-22,1234,1101,138,177,6,-5,144,172,40,0,89
546,Sep 4 1996,Friendly in Czechia,Czechia,Iceland,1931,1561,2,1,1,-1,1932,1560,8,65,0,0,8,65,20,100,470
547,Sep 4 1996,World Cup qualifier in the Faroe Islands,Faroe Islands,Spain,1179,1997,2,6,-1,1,1178,1998,161,4,0,0,161,4,20,100,-718
548,Sep 4 1996,Friendly in Jamaica,Jamaica,Costa Rica,1464,1591,2,0,16,-16,1480,1575,81,62,4,-2,85,60,20,100,-27
549,Sep 4 1996,Southeast Asian Champ in Singapore,Malaysia,Philippines,1257,787,7,0,6,-6,1263,781,137,206,1,0,138,206,40,0,470
550,Sep 4 1996,Friendly in Poland,Poland,Germany,1651,2101,0,2,-4,4,1647,2105,41,1,0,0,41,1,20,100,-350
551,Sep 4 1996,Southeast Asian Champ in Singapore,Singapore,Brunei,1302,815,3,0,2,-2,1304,813,128,205,0,0,128,205,20,0,487
552,Sep 5 1996,Southeast Asian Champ in Singapore,Laos,Vietnam,955,1234,1,1,13,-13,968,1221,187,154,3,-5,190,149,40,0,-279
553,Sep 5 1996,Friendly in Lebanon,Lebanon,Oman,1361,1288,1,2,-15,15,1346,1303,122,124,-3,5,119,129,20,100,173
554,Sep 5 1996,Southeast Asian Champ in Singapore,Myanmar,Cambodia,1128,1101,5,0,37,-37,1165,1064,162,184,2,-6,164,178,40,0,27
555,Sep 6 1996,Southeast Asian Champ in Singapore,Singapore,Philippines,1304,781,3,0,2,-2,1306,779,126,206,1,0,127,206,20,0,523
556,Sep 6 1996,Southeast Asian Champ in Singapore,Thailand,Brunei,1457,813,6,0,2,-2,1459,811,90,205,0,0,90,205,30,0,644
557,Sep 7 1996,Southeast Asian Champ in Singapore,Indonesia,Cambodia,1286,1064,3,0,15,-15,1301,1049,127,180,4,-1,131,179,40,0,222
558,Sep 7 1996,Southeast Asian Champ in Singapore,Vietnam,Myanmar,1221,1165,4,1,29,-29,1250,1136,133,166,8,-1,141,165,40,0,56
559,Sep 8 1996,Southeast Asian Champ in Singapore,Brunei,Philippines,811,779,1,0,18,-18,829,761,201,206,2,0,203,206,40,0,32
560,Sep 8 1996,World Cup qualifier in El Salvador,El Salvador,Cuba,1513,1550,5,0,33,-33,1546,1517,65,77,5,-4,70,73,30,0,-37
561,Sep 8 1996,Friendly in Lebanon,Lebanon,Oman,1346,1303,2,1,6,-6,1352,1297,117,135,1,-3,118,132,20,100,143
562,Sep 8 1996,Southeast Asian Champ in Singapore,Malaysia,Thailand,1263,1459,1,1,10,-10,1273,1449,138,96,0,-3,138,93,40,0,-196
563,Sep 9 1996,Southeast Asian Champ in Singapore,Indonesia,Myanmar,1301,1136,6,1,22,-22,1323,1114,120,171,5,-3,125,168,40,0,165
564,Sep 9 1996,Southeast Asian Champ in Singapore,Laos,Cambodia,968,1049,1,0,25,-25,993,1024,190,193,0,-7,190,186,40,0,-81
565,Sep 10 1996,Southeast Asian Champ in Singapore,Malaysia,Brunei,1273,829,6,0,6,-6,1279,823,138,203,0,0,138,203,40,0,444
566,Sep 10 1996,Southeast Asian Champ in Singapore,Singapore,Thailand,1306,1449,0,1,-18,18,1288,1467,142,85,-7,4,135,89,40,100,-43
567,Sep 11 1996,Southeast Asian Champ in Singapore,Indonesia,Vietnam,1323,1250,1,1,-4,4,1319,1254,125,139,0,1,125,140,40,0,73
568,Sep 11 1996,Friendly in Japan,Japan,Uzbekistan,1737,1676,1,0,6,-6,1743,1670,27,36,0,0,27,36,20,100,161
569,Sep 11 1996,Southeast Asian Champ in Singapore,Myanmar,Laos,1114,993,4,2,20,-20,1134,973,164,190,2,0,166,190,40,0,121
570,Sep 13 1996,Southeast Asian Champ in Singapore,Malaysia,Indonesia,1279,1319,3,1,33,-33,1312,1286,112,147,13,-11,125,136,40,0,-40
571,Sep 13 1996,Southeast Asian Champ in Singapore,Thailand,Vietnam,1467,1254,4,2,14,-14,1481,1240,81,146,4,-3,85,143,40,0,213
572,Sep 14 1996,Simba Cup in South Africa,Australia,Ghana,1669,1625,2,0,20,-20,1689,1605,33,60,2,-7,35,53,30,0,44
573,Sep 14 1996,Simba Cup in South Africa,South Africa,Kenya,1753,1483,1,0,3,-3,1756,1480,26,88,0,-3,26,85,20,0,270
574,Sep 15 1996,World Cup qualifier in Jamaica,Jamaica,Honduras,1480,1562,3,0,33,-33,1513,1529,67,80,9,-8,76,72,40,100,18
575,Sep 15 1996,Friendly in Senegal,Senegal,Mali,1430,1312,1,0,4,-4,1434,1308,97,127,1,-1,98,126,20,100,218
576,Sep 15 1996,World Cup qualifier in St Vincent & Grenadines,St Vincent & Grenadines,Mexico,1283,1844,0,3,-5,5,1278,1849,136,16,1,0,137,16,40,100,-461
577,Sep 15 1996,Southeast Asian Champ in Singapore,Thailand,Malaysia,1481,1312,1,0,11,-11,1492,1301,76,133,4,-4,80,129,40,0,169
578,Sep 15 1996,Southeast Asian Champ in Singapore,Vietnam,Indonesia,1240,1286,3,2,23,-23,1263,1263,133,140,5,-2,138,138,40,0,-46
579,Sep 16 1996,World Cup qualifier in Papua New Guinea,Papua New Guinea,Solomon Islands,1074,1284,1,1,6,-6,1080,1278,175,136,1,0,176,136,40,100,-110
580,Sep 17 1996,Friendly in Oman,Oman,Zambia,1297,1646,0,0,6,-6,1303,1640,125,44,3,-1,128,43,20,100,-249
581,Sep 18 1996,World Cup qualifier in Czechia,Czechia,Malta,1932,1302,6,0,1,-1,1933,1301,8,129,0,0,8,129,20,0,630
582,Sep 18 1996,Simba Cup in South Africa,Ghana,Kenya,1605,1480,1,0,10,-10,1615,1470,47,92,3,-3,50,89,30,0,125
583,Sep 18 1996,Friendly in Romania,Romania,United Arab Emirates,1840,1552,1,2,-18,18,1822,1570,19,61,-1,3,18,64,20,100,388
584,Sep 18 1996,World Cup qualifier in Papua New Guinea,Solomon Islands,Vanuatu,1278,1032,1,1,-12,12,1266,1044,138,179,-1,2,137,181,40,0,246
585,Sep 18 1996,Simba Cup in South Africa,South Africa,Australia,1756,1689,2,0,12,-12,1768,1677,24,37,1,-1,25,36,20,0,67
586,Sep 19 1996,Friendly in El Salvador,El Salvador,Venezuela,1546,1351,0,1,-17,17,1529,1368,73,113,-2,3,71,116,20,100,295
587,Sep 20 1996,World Cup qualifier in Papua New Guinea,Papua New Guinea,Vanuatu,1080,1044,2,1,13,-13,1093,1031,168,185,4,-2,172,183,30,0,36
588,Sep 20 1996,World Cup qualifier in Qatar,Qatar,Sri Lanka,1440,949,3,0,2,-2,1442,947,95,194,0,0,95,194,20,0,491
589,Sep 21 1996,Simba Cup in South Africa,Australia,Kenya,1677,1470,4,0,13,-13,1690,1457,34,91,1,-1,35,90,30,0,207
590,Sep 21 1996,World Cup qualifier in Honduras,Honduras,Mexico,1529,1849,2,1,31,-31,1560,1818,59,22,6,-3,65,19,40,100,-220
591,Sep 21 1996,World Cup qualifier in Qatar,India,Philippines,1058,761,2,0,9,-9,1067,752,178,206,0,0,178,206,40,0,297
592,Sep 21 1996,Simba Cup in South Africa,South Africa,Ghana,1768,1615,0,0,-9,9,1759,1624,27,42,-1,4,26,46,30,100,253
593,Sep 22 1996,Friendly in Guinea,Guinea,Gabon,1324,1516,0,1,-7,7,1317,1523,124,74,0,0,124,74,20,100,-92
594,Sep 22 1996,World Cup qualifier in Panama,Panama,Cuba,1360,1517,1,3,-25,25,1335,1542,127,67,-5,3,122,70,40,100,-57
595,Sep 22 1996,Friendly in Saudi Arabia,Saudi Arabia,Zambia,1605,1640,2,1,8,-8,1613,1632,50,45,2,-1,52,44,20,100,65
596,Sep 22 1996,World Cup qualifier in Slovakia,Slovakia,Malta,1683,1301,6,0,5,-5,1688,1296,36,133,0,-2,36,131,40,100,482
597,Sep 23 1996,Friendly in Mali,Mali,Guinea,1308,1317,0,0,-3,3,1305,1320,128,124,-1,0,127,124,20,100,91
598,Sep 23 1996,World Cup qualifier in Qatar,Qatar,Philippines,1442,752,5,0,1,-1,1443,751,95,208,0,-1,95,207,20,0,690
599,Sep 23 1996,World Cup qualifier in St Vincent & Grenadines,St Vincent & Grenadines,Jamaica,1278,1513,1,2,-13,13,1265,1526,138,72,-1,2,137,74,40,100,-135
600,Sep 24 1996,World Cup qualifier in Qatar,India,Sri Lanka,1067,947,1,1,-7,7,1060,954,178,194,0,0,178,194,40,0,120
601,Sep 25 1996,Friendly in the United States,El Salvador,Guatemala,1529,1465,2,1,8,-8,1537,1457,71,89,1,0,72,89,20,0,64
602,Sep 25 1996,Friendly in Oman,Oman,Mozambique,1303,1354,0,2,-17,17,1286,1371,142,115,-7,1,135,116,20,100,49
603,Sep 25 1996,Friendly in Poland,Poland,United Arab Emirates,1647,1570,1,0,5,-5,1652,1565,41,64,0,0,41,64,20,100,177
604,Sep 25 1996,Friendly in Saudi Arabia,Saudi Arabia,Zambia,1613,1632,1,3,-18,18,1595,1650,58,40,-3,2,55,42,20,100,81
605,Sep 25 1996,Friendly in South Korea,South Korea,China,1629,1605,3,1,10,-10,1639,1595,43,55,1,0,44,55,20,100,124
606,Sep 25 1996,Friendly in Syria,Syria,Sudan,1489,1437,1,2,-14,14,1475,1451,90,89,-4,4,86,93,20,100,152
607,Sep 26 1996,World Cup qualifier in Qatar,Sri Lanka,Philippines,954,751,3,0,17,-17,971,734,188,209,3,-1,191,208,40,0,203
608,Sep 27 1996,World Cup qualifier in Qatar,Qatar,India,1443,1060,6,0,5,-5,1448,1055,94,178,1,0,95,178,40,100,483
609,Sep 29 1996,Friendly in Gabon,Gabon,Mali,1523,1305,1,1,-7,7,1516,1312,75,123,0,2,75,125,20,100,318
610,Sep 29 1996,Friendly in Oman,Oman,New Zealand,1286,1482,0,1,-7,7,1279,1489,135,81,0,1,135,82,20,100,-96
611,Sep 29 1996,Friendly in Syria,Syria,Sudan,1475,1451,1,0,7,-7,1482,1444,82,99,2,-3,84,96,20,100,124
612,Sep 29 1996,Friendly in Zimbabwe,Zimbabwe,Tanzania,1506,1407,1,0,5,-5,1511,1402,77,109,0,-2,77,107,20,100,199
613,Oct 1 1996,Friendly in Oman,Oman,New Zealand,1279,1489,1,2,-7,7,1272,1496,135,78,0,2,135,80,20,100,-110
614,Oct 2 1996,Friendly in Venezuela,Venezuela,Costa Rica,1368,1575,2,0,19,-19,1387,1556,111,72,3,-6,114,66,20,100,-107
615,Oct 3 1996,Friendly in Lebanon,Lebanon,Bahrain,1352,1408,2,3,-11,11,1341,1419,120,102,-1,1,119,103,20,100,44
616,Oct 3 1996,Friendly in Saudi Arabia,Saudi Arabia,New Zealand,1595,1496,3,0,8,-8,1603,1488,53,84,1,-2,54,82,20,100,199
617,Oct 4 1996,African Nations Cup qualifier in Algeria,Algeria,Ivory Coast,1589,1538,4,1,21,-21,1610,1517,50,77,4,-3,54,74,40,100,151
618,Oct 4 1996,Friendly in Ecuador,Ecuador,Jamaica,1696,1526,2,1,3,-3,1699,1523,31,70,1,2,32,72,20,100,270
619,Oct 4 1996,African Nations Cup qualifier in Egypt,Egypt,Morocco,1621,1624,1,1,-5,5,1616,1629,51,46,-1,0,50,46,40,100,97
620,Oct 4 1996,Friendly in Kuwait,Kuwait,Iran,1533,1594,0,1,-11,11,1522,1605,73,53,0,2,73,55,20,100,39
621,Oct 5 1996,World Cup qualifier in Estonia,Estonia,Belarus,1115,1448,1,0,32,-32,1147,1416,162,114,3,-10,165,104,40,100,-233
622,Oct 5 1996,World Cup qualifier in Latvia,Latvia,Scotland,1398,1787,0,2,-10,10,1388,1797,116,19,-4,2,112,21,40,100,-289
623,Oct 5 1996,World Cup qualifier in Lithuania,Lithuania,Iceland,1426,1560,2,0,33,-33,1459,1527,77,78,12,-7,89,71,40,100,-34
624,Oct 5 1996,World Cup qualifier in Moldova,Moldova,Italy,1455,1982,1,3,-5,5,1450,1987,99,5,-4,0,95,5,40,100,-427
625,Oct 5 1996,World Cup qualifier in Northern Ireland,Northern Ireland,Armenia,1611,1306,1,1,-16,16,1595,1322,61,121,-4,3,57,124,40,100,405
626,Oct 5 1996,Friendly in Qatar,Qatar,New Zealand,1448,1488,3,2,8,-8,1456,1480,90,88,2,-3,92,85,20,100,60
627,Oct 5 1996,African Nations Cup qualifier in Togo,Togo,Tanzania,1393,1402,2,1,15,-15,1408,1387,100,119,5,-6,105,113,30,0,-9
628,Oct 5 1996,World Cup qualifier in Ukraine,Ukraine,Portugal,1615,1893,2,1,29,-29,1644,1864,37,18,7,-3,44,15,40,100,-178
629,Oct 5 1996,World Cup qualifier in Wales,Wales,Netherlands,1620,1908,1,3,-15,15,1605,1923,57,10,-4,0,53,10,40,100,-188
630,Oct 6 1996,African Nations Cup qualifier in Benin,Benin,Mali,1177,1312,1,2,-18,18,1159,1330,164,120,-1,3,163,123,40,100,-35
631,Oct 6 1996,African Nations Cup qualifier in Central African Republic,Central African Republic,Guinea,1230,1320,2,3,-21,21,1209,1341,156,113,-5,6,151,119,40,100,10
632,Oct 6 1996,African Nations Cup qualifier in Ethiopia,Ethiopia,Senegal,1336,1434,1,2,-20,20,1316,1454,131,86,-5,6,126,92,40,100,2
633,Oct 6 1996,World Cup qualifier in the Faroe Islands,Faroe Islands,Yugoslavia,1178,1924,1,8,-2,2,1176,1926,161,9,0,0,161,9,30,100,-646
634,Oct 6 1996,World Cup qualifier in Finland,Finland,Switzerland,1484,1728,2,3,-12,12,1472,1740,94,27,-6,1,88,28,40,100,-144
635,Oct 6 1996,African Nations Cup qualifier in Gabon,Gabon,Cameroon,1516,1555,0,0,-3,3,1513,1558,77,63,-1,2,76,65,30,100,61
636,Oct 6 1996,African Nations Cup qualifier in Ghana,Ghana,Angola,1624,1491,2,1,8,-8,1632,1483,46,81,1,0,47,81,40,100,233
637,Oct 6 1996,African Nations Cup qualifier in Mauritius,Mauritius,Malawi,1164,1431,1,2,-11,11,1153,1442,164,93,0,3,164,96,40,100,-167
638,Oct 6 1996,African Nations Cup qualifier in Namibia,Namibia,Kenya,1224,1457,1,0,27,-27,1251,1430,135,104,7,-7,142,97,40,100,-133
639,Oct 6 1996,World Cup qualifier in Panama,Panama,El Salvador,1335,1537,1,1,6,-6,1341,1531,116,72,3,-1,119,71,40,100,-102
640,Oct 6 1996,African Nations Cup qualifier in Sudan,Sudan,Zimbabwe,1444,1511,0,3,-38,38,1406,1549,116,57,-10,10,106,67,40,100,33
641,Oct 6 1996,World Cup qualifier in Trinidad and Tobago,Trinidad and Tobago,Guatemala,1556,1457,1,1,-10,10,1546,1467,73,88,-4,1,69,89,40,100,199
642,Oct 6 1996,African Nations Cup qualifier in Tunisia,Tunisia,Sierra Leone,1622,1439,2,0,10,-10,1632,1429,45,99,2,-1,47,98,40,100,283
643,Oct 6 1996,African Nations Cup qualifier in Zaire,Zaire,Liberia,1515,1407,0,0,-11,11,1504,1418,78,98,-1,4,77,102,40,100,208
644,Oct 6 1996,African Nations Cup qualifier in Zambia,Zambia,Mozambique,1650,1371,1,0,4,-4,1654,1367,40,117,1,0,41,117,40,100,379
645,Oct 7 1996,Friendly in Oman,Oman,Azerbaijan,1272,1476,2,0,19,-19,1291,1457,129,95,3,-5,132,90,20,100,-104
646,Oct 8 1996,World Cup qualifier in Italy,Croatia,Bosnia and Herzegovina,1899,1573,4,1,9,-9,1908,1564,11,64,0,-1,11,63,40,0,326
647,Oct 8 1996,Friendly in the United Arab Emirates,Cyprus,Kuwait,1389,1522,1,1,4,-4,1393,1518,107,74,2,0,109,74,20,0,-133
648,Oct 8 1996,World Cup qualifier in Luxembourg,Luxembourg,Bulgaria,1261,1821,1,2,-3,3,1258,1824,140,14,0,2,140,16,40,100,-460
649,Oct 8 1996,World Cup qualifier in Uruguay,Uruguay,Bolivia,1765,1659,1,0,9,-9,1774,1650,25,46,0,-4,25,42,40,100,206
650,Oct 9 1996,World Cup qualifier in Albania,Albania,Portugal,1453,1864,0,3,-10,10,1443,1874,97,13,-2,1,95,14,40,100,-311
651,Oct 9 1996,World Cup qualifier in Armenia,Armenia,Germany,1322,2105,1,5,-1,1,1321,2106,125,1,0,0,125,1,20,100,-683
652,Oct 9 1996,World Cup qualifier in Belarus,Belarus,Latvia,1416,1388,1,1,-7,7,1409,1395,104,106,0,3,104,109,40,100,128
653,Oct 9 1996,Friendly in Costa Rica,Costa Rica,Jamaica,1556,1523,0,0,-4,4,1552,1527,66,71,0,1,66,72,20,100,133
654,Oct 9 1996,World Cup qualifier in Czechia,Czechia,Spain,1933,1998,0,0,-2,2,1931,2000,8,4,0,0,8,4,30,100,35
655,Oct 9 1996,World Cup qualifier in Denmark,Denmark,Greece,1957,1656,2,1,4,-4,1961,1652,6,43,0,-2,6,41,40,100,401
656,Oct 9 1996,World Cup qualifier in Ecuador,Ecuador,Colombia,1699,1892,0,1,-15,15,1684,1907,40,12,-4,0,36,12,40,100,-93
657,Oct 9 1996,World Cup qualifier in England,England,Poland,1938,1652,2,1,4,-4,1942,1648,7,45,0,-2,7,43,40,100,386
658,Oct 9 1996,Friendly in France,France,Turkey,2021,1698,4,0,3,-3,2024,1695,3,33,0,0,3,33,20,100,423
659,Oct 9 1996,World Cup qualifier in Iceland,Iceland,Romania,1527,1822,0,4,-18,18,1509,1840,80,12,-4,3,76,15,40,100,-195
660,Oct 9 1996,World Cup qualifier in Ireland,Ireland,Macedonia,1735,1549,3,0,11,-11,1746,1538,25,73,2,-3,27,70,40,100,286
661,Oct 9 1996,World Cup qualifier in Israel,Israel,Russia,1645,1891,1,1,8,-8,1653,1883,37,13,3,0,40,13,40,100,-146
662,Oct 9 1996,World Cup qualifier in Italy,Italy,Georgia,1987,1635,1,0,3,-3,1990,1632,5,46,0,0,5,46,30,0,352
663,Oct 9 1996,Friendly in Lebanon,Lebanon,New Zealand,1341,1480,1,1,1,-1,1342,1479,119,84,0,0,119,84,20,100,-39
664,Oct 9 1996,World Cup qualifier in Lithuania,Lithuania,Liechtenstein,1459,1093,2,1,3,-3,1462,1090,89,174,0,-1,89,173,30,0,366
665,Oct 9 1996,World Cup qualifier in Norway,Norway,Hungary,1824,1597,3,0,9,-9,1833,1588,18,60,-1,-2,17,58,40,100,327
666,Oct 9 1996,World Cup qualifier in Paraguay,Paraguay,Chile,1794,1722,2,1,11,-11,1805,1711,20,34,1,-2,21,32,40,100,172
667,Oct 9 1996,World Cup qualifier in San Marino,San Marino,Belgium,958,1786,0,3,-1,1,957,1787,195,24,-1,0,194,24,20,100,-728
668,Oct 9 1996,Friendly in Saudi Arabia,Saudi Arabia,Australia,1603,1690,0,0,0,0,1603,1690,55,33,0,1,55,34,20,100,13
669,Oct 9 1996,World Cup qualifier in Sweden,Sweden,Austria,1868,1695,0,1,-33,33,1835,1728,18,26,-2,4,16,30,40,100,273
670,Oct 9 1996,World Cup qualifier in Venezuela,Venezuela,Argentina,1387,1803,2,5,-10,10,1377,1813,117,20,-2,0,115,20,40,100,-316
671,Oct 10 1996,World Cup qualifier in Canada,Canada,Cuba,1613,1542,2,0,16,-16,1629,1526,47,75,2,-3,49,72,40,100,171
672,Oct 13 1996,World Cup qualifier in Canada,Canada,Cuba,1629,1526,2,0,14,-14,1643,1512,41,78,4,-3,45,75,40,100,203
673,Oct 13 1996,Friendly in Japan,Japan,Tunisia,1743,1632,1,0,5,-5,1748,1627,26,54,1,-4,27,50,20,100,211
674,Oct 13 1996,World Cup qualifier in St Vincent & Grenadines,St Vincent & Grenadines,Honduras,1265,1560,1,4,-17,17,1248,1577,147,56,-5,4,142,60,40,100,-195
675,Oct 15 1996,Gulf Cup in Oman,Oman,Saudi Arabia,1291,1603,0,1,-9,9,1282,1612,138,49,-3,3,135,52,40,100,-212
676,Oct 16 1996,Friendly in Brazil,Brazil,Lithuania,2062,1462,3,1,1,-1,2063,1461,2,91,0,-1,2,90,20,0,600
677,Oct 16 1996,Gulf Cup in Oman,Kuwait,Bahrain,1518,1419,1,0,14,-14,1532,1405,68,113,2,-6,70,107,40,0,99
678,Oct 16 1996,World Cup qualifier in Mexico,Mexico,Jamaica,1818,1527,2,1,4,-4,1822,1523,19,73,0,-1,19,72,40,100,391
679,Oct 16 1996,Friendly in Peru,Peru,United States,1581,1722,4,1,20,-20,1601,1702,53,33,3,-1,56,32,20,100,-41
680,Oct 16 1996,Gulf Cup in Oman,Qatar,United Arab Emirates,1456,1565,1,0,26,-26,1482,1539,73,73,9,-5,82,68,40,0,-109
681,Oct 18 1996,Gulf Cup in Oman,Bahrain,United Arab Emirates,1405,1539,1,1,7,-7,1412,1532,99,72,4,-2,103,70,40,0,-134
682,Oct 18 1996,Friendly in Benin,Benin,Ghana,1159,1632,0,0,8,-8,1167,1624,163,53,0,-3,163,50,20,100,-373
683,Oct 18 1996,Gulf Cup in Oman,Oman,Kuwait,1282,1532,1,2,-12,12,1270,1544,135,66,0,2,135,68,40,100,-150
684,Oct 19 1996,Friendly in Gabon,Gabon,Burkina Faso,1513,1386,2,0,6,-6,1519,1380,72,114,1,0,73,114,20,100,227
685,Oct 19 1996,Gulf Cup in Oman,Qatar,Saudi Arabia,1482,1612,2,2,7,-7,1489,1605,80,54,1,-1,81,53,40,0,-130
686,Oct 21 1996,Friendly in Honduras,Honduras,El Salvador,1577,1531,1,1,-4,4,1573,1535,64,69,-2,1,62,70,20,100,146
687,Oct 21 1996,Gulf Cup in Oman,Oman,Qatar,1270,1489,0,3,-23,23,1247,1512,149,69,-7,6,142,75,40,100,-119
688,Oct 21 1996,Gulf Cup in Oman,Saudi Arabia,Bahrain,1605,1412,3,1,15,-15,1620,1397,49,111,2,-4,51,107,40,0,193
689,Oct 22 1996,Gulf Cup in Oman,United Arab Emirates,Kuwait,1532,1544,2,1,21,-21,1553,1523,59,74,6,-3,65,71,40,0,-12
690,Oct 23 1996,Friendly in the United States,Ecuador,Mexico,1684,1822,1,0,14,-14,1698,1808,30,21,3,-1,33,20,20,0,-138
691,Oct 23 1996,World Cup qualifier in Slovakia,Slovakia,Faroe Islands,1688,1176,3,0,2,-2,1690,1174,35,163,0,-1,35,162,20,0,512
692,Oct 24 1996,Gulf Cup in Oman,Kuwait,Saudi Arabia,1523,1620,1,0,25,-25,1548,1595,63,61,4,-5,67,56,40,0,-97
693,Oct 24 1996,Gulf Cup in Oman,Oman,United Arab Emirates,1247,1553,0,0,11,-11,1258,1542,134,73,4,-4,138,69,30,0,-306
694,Oct 25 1996,Gulf Cup in Oman,Qatar,Bahrain,1512,1397,2,1,14,-14,1526,1383,69,119,3,-6,72,113,40,0,115
695,Oct 26 1996,World Cup qualifier in Honduras,Honduras,Jamaica,1573,1523,0,0,-8,8,1565,1531,62,71,0,1,62,72,40,100,150
696,Oct 27 1996,World Cup qualifier in Panama,Panama,Canada,1341,1643,0,0,10,-10,1351,1633,116,47,2,-1,118,46,40,100,-202
697,Oct 27 1996,Gulf Cup in Oman,Saudi Arabia,United Arab Emirates,1595,1542,2,2,-3,3,1592,1545,60,67,-2,1,58,68,40,0,53
698,Oct 27 1996,Oceania Nations Cup in Tahiti,Tahiti,Australia,1575,1690,0,6,-51,51,1524,1741,86,23,-13,6,73,29,50,100,-15
699,Oct 28 1996,Gulf Cup in Oman,Kuwait,Qatar,1548,1526,2,1,19,-19,1567,1507,56,82,5,-5,61,77,40,0,22
700,Oct 28 1996,Gulf Cup in Oman,Oman,Bahrain,1258,1383,1,1,1,-1,1259,1382,138,113,0,0,138,113,20,100,-25
701,Oct 30 1996,Friendly in Finland,Finland,Estonia,1472,1147,2,2,-8,8,1464,1155,90,163,-1,1,89,164,20,100,425
702,Oct 30 1996,World Cup qualifier in Mexico,Mexico,St Vincent & Grenadines,1808,1248,5,1,2,-2,1810,1246,20,144,0,-1,20,143,30,0,560
703,Oct 30 1996,Friendly in Italy,Moldova,Indonesia,1450,1263,2,1,5,-5,1455,1258,90,140,2,-2,92,138,20,0,187
704,Nov 1 1996,Oceania Nations Cup in Australia,Australia,Tahiti,1741,1524,5,0,14,-14,1755,1510,25,78,2,-3,27,75,50,100,317
705,Nov 1 1996,Friendly in the United States,Colombia,Honduras,1907,1565,2,1,2,-2,1909,1563,10,64,1,-1,11,63,20,0,342
706,Nov 2 1996,Friendly in Costa Rica,Costa Rica,Panama,1552,1351,2,0,5,-5,1557,1346,65,118,0,0,65,118,20,100,301
707,Nov 3 1996,World Cup qualifier in Canada,Canada,El Salvador,1633,1535,1,0,10,-10,1643,1525,44,74,1,-2,45,72,40,100,198
708,Nov 3 1996,Friendly in Lithuania,Lithuania,Indonesia,1461,1258,4,0,6,-6,1467,1252,86,142,2,-2,88,140,20,100,303
709,Nov 3 1996,Friendly in Togo,Togo,Gabon,1408,1519,0,1,-10,10,1398,1529,108,70,-2,1,106,71,20,100,-11
710,Nov 3 1996,World Cup qualifier in the United States,United States,Guatemala,1702,1467,2,0,8,-8,1710,1459,33,92,0,-2,33,90,40,100,335
711,Nov 6 1996,Friendly in Bosnia and Herzegovina,Bosnia and Herzegovina,Italy,1564,1990,2,1,17,-17,1581,1973,58,5,2,0,60,5,20,100,-326
712,Nov 6 1996,World Cup qualifier in Mexico,Mexico,Honduras,1810,1563,3,1,7,-7,1817,1556,16,67,2,-2,18,65,40,100,347
713,Nov 6 1996,Friendly in Saudi Arabia,Saudi Arabia,Bulgaria,1592,1824,1,0,14,-14,1606,1810,48,22,5,-2,53,20,20,100,-132
714,Nov 7 1996,Friendly in Costa Rica,Costa Rica,Panama,1557,1346,2,0,4,-4,1561,1342,62,120,1,-1,63,119,20,100,311
715,Nov 7 1996,Friendly in Uganda,Uganda,Rwanda,1344,1088,3,2,2,-2,1346,1086,117,174,1,0,118,174,20,100,356
716,Nov 8 1996,World Cup qualifier in Egypt,Egypt,Namibia,1616,1251,7,1,5,-5,1621,1246,51,143,0,-1,51,142,20,0,365
717,Nov 8 1996,Friendly in Thailand,Thailand,Bulgaria,1492,1810,0,4,-8,8,1484,1818,81,16,0,2,81,18,20,100,-218
718,Nov 9 1996,World Cup qualifier in Albania,Albania,Armenia,1443,1321,1,1,-11,11,1432,1332,97,121,-1,2,96,123,40,100,222
719,Nov 9 1996,World Cup qualifier in Austria,Austria,Latvia,1728,1395,2,1,3,-3,1731,1392,31,110,0,-1,31,109,20,0,333
720,Nov 9 1996,Friendly in Denmark,Denmark,France,1961,2024,1,0,9,-9,1970,2015,6,3,0,0,6,3,20,100,37
721,Nov 9 1996,World Cup qualifier in Georgia,Georgia,England,1632,1942,0,2,-14,14,1618,1956,55,7,-4,0,51,7,40,100,-210
722,Nov 9 1996,World Cup qualifier in Germany,Germany,Northern Ireland,2106,1595,1,1,-19,19,2087,1614,1,47,0,5,1,52,40,100,611
723,Nov 9 1996,World Cup qualifier in Liechtenstein,Liechtenstein,Macedonia,1090,1538,1,11,-12,12,1078,1550,179,63,-3,3,176,66,40,100,-348
724,Nov 9 1996,World Cup qualifier in Morocco,Morocco,Sierra Leone,1629,1429,4,0,11,-11,1640,1418,42,102,3,-2,45,100,40,100,300
725,Nov 9 1996,World Cup qualifier in the Netherlands,Netherlands,Wales,1923,1605,7,1,7,-7,1930,1598,8,60,1,-3,9,57,40,100,418
726,Nov 9 1996,World Cup qualifier in Nigeria,Nigeria,Burkina Faso,1792,1380,2,0,3,-3,1795,1377,23,114,0,0,23,114,20,0,412
727,Nov 9 1996,World Cup qualifier in Portugal,Portugal,Ukraine,1874,1644,1,0,5,-5,1879,1639,14,48,0,-2,14,46,40,100,330
728,Nov 9 1996,World Cup qualifier in South Africa,South Africa,Zaire,1759,1504,1,0,5,-5,1764,1499,26,80,0,-1,26,79,40,100,355
729,Nov 10 1996,World Cup qualifier in Angola,Angola,Zimbabwe,1483,1549,2,1,18,-18,1501,1531,76,75,3,-4,79,71,30,0,-66
730,Nov 10 1996,World Cup qualifier in Azerbaijan,Azerbaijan,Hungary,1457,1588,0,3,-32,32,1425,1620,105,41,-7,9,98,50,40,100,-31
731,Nov 10 1996,World Cup qualifier in Bolivia,Bolivia,Colombia,1650,1909,2,2,9,-9,1659,1900,36,11,3,0,39,11,30,0,-259
732,Nov 10 1996,World Cup qualifier in Congo,Congo,Zambia,1397,1654,1,0,28,-28,1425,1626,89,55,9,-8,98,47,40,100,-157
733,Nov 10 1996,World Cup qualifier in Croatia,Croatia,Greece,1908,1652,1,1,-15,15,1893,1667,12,35,0,3,12,38,40,100,356
734,Nov 10 1996,World Cup qualifier in Cyprus,Cyprus,Israel,1393,1653,2,0,43,-43,1436,1610,82,66,13,-13,95,53,40,100,-160
735,Nov 10 1996,World Cup qualifier in El Salvador,El Salvador,Panama,1525,1342,3,2,7,-7,1532,1335,68,125,2,-3,70,122,40,100,283
736,Nov 10 1996,World Cup qualifier in Gabon,Gabon,Ghana,1529,1624,1,1,0,0,1529,1624,73,47,-1,1,72,48,20,100,5
737,Nov 10 1996,World Cup qualifier in Guinea,Guinea,Kenya,1341,1430,3,1,29,-29,1370,1401,111,117,5,-10,116,107,40,100,11
738,Nov 10 1996,World Cup qualifier in Ireland,Ireland,Iceland,1746,1509,0,0,-15,15,1731,1524,29,70,0,3,29,73,40,100,337
739,Nov 10 1996,World Cup qualifier in Jamaica,Jamaica,St Vincent & Grenadines,1531,1246,5,0,8,-8,1539,1238,66,146,2,-2,68,144,40,100,385
740,Nov 10 1996,World Cup qualifier in Luxembourg,Luxembourg,Russia,1258,1883,0,4,-3,3,1255,1886,138,13,0,0,138,13,30,100,-525
741,Nov 10 1996,World Cup qualifier in Paraguay,Paraguay,Ecuador,1805,1698,1,0,9,-9,1814,1689,19,38,1,-2,20,36,40,100,207
742,Nov 10 1996,World Cup qualifier in Peru,Peru,Venezuela,1601,1377,4,1,9,-9,1610,1368,50,120,3,-3,53,117,40,100,324
743,Nov 10 1996,World Cup qualifier in Poland,Poland,Moldova,1648,1455,2,1,6,-6,1654,1449,39,94,2,-1,41,93,40,100,293
744,Nov 10 1996,World Cup qualifier in Scotland,Scotland,Sweden,1797,1835,1,0,16,-16,1813,1819,20,18,1,-1,21,17,40,100,62
745,Nov 10 1996,World Cup qualifier in Slovenia,Slovenia,Bosnia and Herzegovina,1574,1581,1,2,-25,25,1549,1606,71,52,-5,4,66,56,40,100,93
746,Nov 10 1996,World Cup qualifier in Switzerland,Switzerland,Norway,1740,1833,0,1,-20,20,1720,1853,34,13,-2,2,32,15,40,100,7
747,Nov 10 1996,World Cup qualifier in Togo,Togo,Cameroon,1398,1558,2,4,-25,25,1373,1583,124,58,-9,3,115,61,40,100,-60
748,Nov 10 1996,World Cup qualifier in Ghana,Tunisia,Liberia,1627,1418,1,0,9,-9,1636,1409,44,106,2,-3,46,103,40,0,209
749,Nov 10 1996,World Cup qualifier in Turkey,Turkey,San Marino,1695,957,7,0,1,-1,1696,956,33,194,1,0,34,194,20,0,738
750,Nov 10 1996,World Cup qualifier in the United States,United States,Trinidad and Tobago,1710,1546,2,0,11,-11,1721,1535,29,70,2,-1,31,69,40,100,264
751,Nov 10 1996,World Cup qualifier in Yugoslavia,Yugoslavia,Czechia,1926,1931,1,0,15,-15,1941,1916,6,12,2,-2,8,10,30,0,-5
752,Nov 11 1996,World Cup qualifier in Tonga,Tonga,Cook Islands,680,692,2,0,23,-23,703,669,206,214,3,-2,209,212,30,0,-12
753,Nov 12 1996,World Cup qualifier in Chile,Chile,Uruguay,1711,1774,1,0,18,-18,1729,1756,29,27,2,-1,31,26,30,0,-63
754,Nov 13 1996,Friendly in Andorra,Andorra,Estonia,1100,1155,1,6,-23,23,1077,1178,177,161,0,0,177,161,20,100,45
755,Nov 13 1996,Friendly in Brazil,Brazil,Cameroon,2063,1583,2,0,1,-1,2064,1582,2,61,0,0,2,61,20,100,580
756,Nov 13 1996,Friendly in Lebanon,Lebanon,Iran,1342,1605,0,0,4,-4,1346,1601,118,58,1,0,119,58,20,100,-163
757,Nov 13 1996,World Cup qualifier in Spain,Spain,Slovakia,2000,1690,4,1,6,-6,2006,1684,4,37,0,-1,4,36,40,100,410
758,Nov 13 1996,Friendly in the United Arab Emirates,United Arab Emirates,Malta,1545,1296,1,1,-8,8,1537,1304,69,126,-1,2,68,128,20,100,349
759,Nov 13 1996,World Cup qualifier in Tonga,Western Samoa,Cook Islands,616,669,2,1,23,-23,639,646,215,216,0,-2,215,214,40,0,-53
760,Nov 14 1996,Friendly in Uganda,Uganda,Rwanda,1346,1086,3,2,2,-2,1348,1084,119,175,0,-1,119,174,20,100,360
761,Nov 15 1996,World Cup qualifier in Tonga,Tonga,Western Samoa,703,639,1,0,11,-11,714,628,210,215,0,0,210,215,40,100,164
762,Nov 15 1996,Friendly in the United Arab Emirates,United Arab Emirates,Malta,1537,1304,0,0,-7,7,1530,1311,74,128,-3,0,71,128,20,100,333
763,Nov 15 1996,Friendly in Uganda,Uganda,Rwanda,1348,1084,1,1,-8,8,1340,1092,121,172,-1,1,120,173,20,100,364
764,Nov 16 1996,Friendly in Italy,Estonia,Indonesia,1178,1252,3,0,21,-21,1199,1231,151,152,5,-6,156,146,20,0,-74
765,Nov 16 1996,Friendly in Saudi Arabia,Saudi Arabia,Syria,1606,1482,3,1,6,-6,1612,1476,50,87,3,-2,53,85,20,100,224
766,Nov 17 1996,World Cup qualifier in Costa Rica,Costa Rica,Guatemala,1561,1459,3,0,17,-17,1578,1442,61,96,1,-3,62,93,40,100,202
767,Nov 17 1996,World Cup qualifier in Honduras,Honduras,St Vincent & Grenadines,1556,1238,11,3,8,-8,1564,1230,66,149,-1,-3,65,146,40,100,418
768,Nov 17 1996,World Cup qualifier in Jamaica,Jamaica,Mexico,1539,1817,1,0,29,-29,1568,1788,59,27,4,-4,63,23,40,100,-178
769,Nov 17 1996,CECAFA Cup in Sudan,Sudan,Uganda,1406,1340,1,1,-9,9,1397,1349,109,118,-2,1,107,119,40,100,166
770,Nov 19 1996,CECAFA Cup in Sudan,Kenya,Rwanda,1401,1092,2,1,6,-6,1407,1086,104,173,1,0,105,173,40,0,309
771,Nov 19 1996,Friendly in Kuwait,Kuwait,Syria,1567,1476,2,2,-5,5,1562,1481,66,83,-1,1,65,84,20,100,191
772,Nov 19 1996,Friendly in Saudi Arabia,Saudi Arabia,Mali,1612,1330,1,3,-27,27,1585,1357,67,114,-7,5,60,119,20,100,382
773,Nov 19 1996,Friendly in the United Arab Emirates,United Arab Emirates,Uzbekistan,1530,1670,4,2,17,-17,1547,1653,65,45,3,-4,68,41,20,100,-40
774,Nov 20 1996,Friendly in the United States,Mexico,El Salvador,1788,1532,3,1,6,-6,1794,1526,23,74,0,-2,23,72,20,0,256
775,Nov 22 1996,Friendly in Kuwait,Kuwait,Mali,1562,1357,4,2,4,-4,1566,1353,63,121,1,-1,64,120,20,100,305
776,Nov 22 1996,CECAFA Cup in Sudan,Rwanda,Zanzibar,1086,1187,1,1,6,-6,1092,1181,173,163,0,-2,173,161,40,0,-101
777,Nov 22 1996,Friendly in the United Arab Emirates,United Arab Emirates,Uzbekistan,1547,1653,2,0,15,-15,1562,1638,64,49,2,-4,66,45,20,100,-6
778,Nov 22 1996,CECAFA Cup in Sudan,Uganda,Tanzania,1349,1387,1,0,22,-22,1371,1365,110,127,5,-8,115,119,40,0,-38
779,Nov 23 1996,Friendly in Italy,Iraq,Indonesia,1658,1231,4,0,3,-3,1661,1228,39,149,0,-2,39,147,20,0,427
780,Nov 23 1996,Friendly in South Korea,South Korea,Colombia,1639,1900,4,1,25,-25,1664,1875,33,17,5,-3,38,14,20,100,-161
781,Nov 24 1996,World Cup qualifier in the United States,Guatemala,Costa Rica,1442,1578,1,0,27,-27,1469,1551,83,70,5,-4,88,66,40,0,-136
782,Nov 24 1996,CECAFA Cup in Sudan,Kenya,Zanzibar,1407,1181,1,0,9,-9,1416,1172,101,165,2,-2,103,163,40,0,226
783,Nov 24 1996,Friendly in Mali,Mali,Burkina Faso,1353,1377,2,0,12,-12,1365,1365,116,124,2,-6,118,118,20,100,76
784,Nov 24 1996,CECAFA Cup in Sudan,Sudan,Tanzania,1397,1365,3,2,13,-13,1410,1352,101,121,3,-1,104,120,40,100,132
785,Nov 24 1996,World Cup qualifier in Trinidad and Tobago,Trinidad and Tobago,United States,1535,1721,0,1,-15,15,1520,1736,77,26,-4,3,73,29,40,100,-86
786,Nov 25 1996,Friendly in Iran,Iran,Turkmenistan,1601,1406,0,1,-17,17,1584,1423,63,93,-3,7,60,100,20,100,295
787,Nov 26 1996,Friendly in China,China,South Korea,1595,1664,2,3,-11,11,1584,1675,60,36,-1,1,59,37,20,100,31
788,Nov 26 1996,Friendly in the United Arab Emirates,United Arab Emirates,Syria,1562,1481,1,1,-5,5,1557,1486,65,80,0,2,65,82,20,100,181
789,Nov 27 1996,Friendly in Malta,Malta,Macedonia,1311,1550,0,2,-9,9,1302,1559,128,63,0,2,128,65,20,100,-139
790,Nov 27 1996,CECAFA Cup in Sudan,Uganda,Kenya,1371,1416,2,0,34,-34,1405,1382,100,118,7,-7,107,111,40,0,-45
791,Nov 28 1996,Friendly in the United Arab Emirates,United Arab Emirates,Syria,1557,1486,1,0,5,-5,1562,1481,64,86,1,-2,65,84,20,100,171
792,Nov 29 1996,Friendly in Saudi Arabia,Saudi Arabia,Indonesia,1585,1228,4,1,2,-2,1587,1226,58,149,0,-1,58,148,20,100,457
793,Nov 29 1996,CECAFA Cup in Sudan,Sudan,Kenya,1410,1382,1,1,-7,7,1403,1389,110,111,-3,0,107,111,40,100,128
794,Dec 1 1996,World Cup qualifier in Costa Rica,Costa Rica,United States,1551,1736,2,1,25,-25,1576,1711,57,37,5,-4,62,33,40,100,-85
795,Dec 1 1996,World Cup qualifier in El Salvador,El Salvador,Cuba,1526,1512,3,0,24,-24,1550,1488,65,87,3,-6,68,81,40,100,114
796,Dec 4 1996,Asian Cup in the United Arab Emirates,Indonesia,Kuwait,1226,1566,2,2,19,-19,1245,1547,138,74,5,-5,143,69,50,0,-340
797,Dec 4 1996,Asian Cup in the United Arab Emirates,United Arab Emirates,South Korea,1562,1675,1,1,1,-1,1563,1674,64,37,1,0,65,37,30,100,-13
798,Dec 5 1996,Asian Cup in the United Arab Emirates,Iraq,Iran,1661,1584,2,1,20,-20,1681,1564,35,67,2,-4,37,63,50,0,77
799,Dec 5 1996,Friendly in Lebanon,Lebanon,Georgia,1346,1618,4,2,22,-22,1368,1596,111,65,5,-7,116,58,20,100,-172
800,Dec 5 1996,Asian Cup in the United Arab Emirates,Saudi Arabia,Thailand,1587,1484,6,0,38,-38,1625,1446,38,104,10,-11,48,93,50,0,103
801,Dec 6 1996,Asian Cup in the United Arab Emirates,Japan,Syria,1748,1481,2,1,9,-9,1757,1472,24,89,2,-3,26,86,50,0,267
802,Dec 6 1996,Asian Cup in the United Arab Emirates,Uzbekistan,China,1638,1584,2,0,32,-32,1670,1552,33,73,6,-7,39,66,50,0,54
803,Dec 7 1996,Asian Cup in the United Arab Emirates,South Korea,Indonesia,1674,1245,4,2,6,-6,1680,1239,38,143,0,0,38,143,50,0,429
804,Dec 7 1996,Asian Cup in the United Arab Emirates,United Arab Emirates,Kuwait,1563,1547,3,2,17,-17,1580,1530,56,71,4,-1,60,70,50,100,116
805,Dec 8 1996,World Cup qualifier in the United States,Guatemala,Trinidad and Tobago,1469,1520,2,1,23,-23,1492,1497,75,85,6,-6,81,79,40,0,-51
806,Dec 8 1996,Asian Cup in the United Arab Emirates,Iran,Thailand,1564,1446,3,1,25,-25,1589,1421,53,107,5,-7,58,100,50,0,118
807,Dec 8 1996,Friendly in Lebanon,Lebanon,Georgia,1368,1596,3,2,14,-14,1382,1582,108,60,4,-1,112,59,20,100,-128
808,Dec 8 1996,Asian Cup in the United Arab Emirates,Saudi Arabia,Iraq,1625,1681,1,0,29,-29,1654,1652,34,49,7,-6,41,43,50,0,-56
809,Dec 9 1996,Asian Cup in the United Arab Emirates,China,Syria,1552,1472,3,0,34,-34,1586,1438,52,99,7,-6,59,93,50,0,80
810,Dec 9 1996,Asian Cup in the United Arab Emirates,Japan,Uzbekistan,1757,1670,4,0,35,-35,1792,1635,22,56,2,-9,24,47,50,0,87
811,Dec 10 1996,Asian Cup in the United Arab Emirates,Kuwait,South Korea,1530,1680,2,0,53,-53,1583,1627,52,57,9,-10,61,47,50,0,-150
812,Dec 10 1996,Asian Cup in the United Arab Emirates,United Arab Emirates,Indonesia,1580,1239,2,0,5,-5,1585,1234,58,145,2,-1,60,144,50,100,441
813,Dec 11 1996,Friendly tournament in Morocco,Czechia,Nigeria,1916,1795,2,1,10,-10,1926,1785,10,28,0,-3,10,25,30,0,121
814,Dec 11 1996,Asian Cup in the United Arab Emirates,Iran,Saudi Arabia,1589,1654,3,0,52,-52,1641,1602,28,75,15,-18,43,57,50,0,-65
815,Dec 11 1996,Asian Cup in the United Arab Emirates,Iraq,Thailand,1652,1421,4,1,18,-18,1670,1403,33,112,4,-6,37,106,50,0,231
816,Dec 11 1996,Friendly tournament in Morocco,Morocco,Croatia,1640,1893,2,2,6,-6,1646,1887,39,11,2,0,41,11,20,0,-253
817,Dec 12 1996,Friendly tournament in Morocco,Croatia,Czechia,1887,1926,1,1,2,-2,1889,1924,11,10,0,0,11,10,30,0,-39
818,Dec 12 1996,Asian Cup in the United Arab Emirates,Japan,China,1792,1586,1,0,12,-12,1804,1574,21,69,1,-5,22,64,50,0,206
819,Dec 12 1996,Friendly tournament in Morocco,Morocco,Nigeria,1646,1785,2,0,25,-25,1671,1760,33,27,4,-1,37,26,30,100,-39
820,Dec 12 1996,Asian Cup in the United Arab Emirates,Syria,Uzbekistan,1438,1635,2,1,38,-38,1476,1597,77,70,8,-12,85,58,50,0,-197
821,Dec 14 1996,World Cup qualifier in Belgium,Belgium,Netherlands,1787,1930,0,3,-31,31,1756,1961,28,5,-2,2,26,7,40,100,-43
822,Dec 14 1996,World Cup qualifier in Cyprus,Cyprus,Bulgaria,1436,1818,1,3,-10,10,1426,1828,96,16,-1,1,95,17,40,100,-282
823,Dec 14 1996,Friendly in Kenya,Kenya,Zambia,1389,1626,1,0,14,-14,1403,1612,101,55,5,-4,106,51,20,100,-137
824,Dec 14 1996,World Cup qualifier in Macedonia,Macedonia,Romania,1559,1840,0,3,-18,18,1541,1858,71,14,-2,1,69,15,40,100,-181
825,Dec 14 1996,World Cup qualifier in Northern Ireland,Northern Ireland,Albania,1614,1432,2,0,10,-10,1624,1422,43,103,4,-4,47,99,40,100,282
826,Dec 14 1996,World Cup qualifier in Portugal,Portugal,Germany,1879,2087,0,0,6,-6,1885,2081,13,1,0,0,13,1,40,100,-108
827,Dec 14 1996,World Cup qualifier in Spain,Spain,Yugoslavia,2006,1941,2,0,17,-17,2023,1924,2,10,1,-1,3,9,40,100,165
828,Dec 14 1996,World Cup qualifier in the United States,United States,Costa Rica,1711,1576,2,1,8,-8,1719,1568,33,65,0,-1,33,64,40,100,235
829,Dec 14 1996,World Cup qualifier in Wales,Wales,Turkey,1598,1696,0,0,0,0,1598,1696,57,34,0,0,57,34,20,100,2
830,Dec 15 1996,World Cup qualifier in Argentina,Argentina,Chile,1813,1729,1,1,-10,10,1803,1739,22,27,-1,2,21,29,40,100,184
831,Dec 15 1996,World Cup qualifier in Bolivia,Bolivia,Paraguay,1659,1814,0,0,3,-3,1662,1811,40,21,0,-1,40,20,40,100,-55
832,Dec 15 1996,World Cup qualifier in El Salvador,El Salvador,Canada,1550,1643,0,2,-31,31,1519,1674,77,32,-5,5,72,37,40,100,7
833,Dec 15 1996,World Cup qualifier in Israel,Israel,Luxembourg,1610,1255,1,0,3,-3,1613,1252,54,140,-1,-1,53,139,30,0,355
834,Dec 15 1996,Friendly in Kenya,Kenya,Zambia,1403,1612,0,2,-10,10,1393,1622,110,49,-2,1,108,50,20,100,-109
835,Dec 15 1996,Asian Cup in the United Arab Emirates,Kuwait,Japan,1583,1804,2,0,59,-59,1642,1745,26,34,17,-6,43,28,50,0,-221
836,Dec 15 1996,World Cup qualifier in Panama,Panama,Cuba,1335,1488,3,1,35,-35,1370,1453,109,98,7,-8,116,90,40,100,-53
837,Dec 15 1996,Asian Cup in the United Arab Emirates,United Arab Emirates,Iraq,1585,1670,1,0,24,-24,1609,1646,51,46,4,-4,55,42,50,100,15
838,Dec 15 1996,World Cup qualifier in Uruguay,Uruguay,Peru,1756,1610,2,0,12,-12,1768,1598,20,64,3,-6,23,58,40,100,246
839,Dec 15 1996,World Cup qualifier in Venezuela,Venezuela,Colombia,1368,1875,0,2,-5,5,1363,1880,125,14,-4,0,121,14,40,100,-407
840,Dec 16 1996,Asian Cup in the United Arab Emirates,Iran,South Korea,1641,1627,6,2,45,-45,1686,1582,28,73,8,-13,36,60,50,0,14
841,Dec 16 1996,Asian Cup in the United Arab Emirates,Saudi Arabia,China,1602,1574,4,3,23,-23,1625,1551,37,69,10,-3,47,66,50,0,28
842,Dec 18 1996,Friendly in Brazil,Brazil,Bosnia and Herzegovina,2064,1606,1,0,1,-1,2065,1605,2,56,0,0,2,56,20,0,458
843,Dec 18 1996,Asian Cup in the United Arab Emirates,Iran,Saudi Arabia,1686,1625,0,0,-4,4,1682,1629,38,45,-1,1,37,46,20,100,161
844,Dec 18 1996,World Cup qualifier in Malta,Malta,Spain,1302,2023,0,3,-2,2,1300,2025,130,3,-1,0,129,3,40,100,-621
845,Dec 18 1996,Asian Cup in the United Arab Emirates,United Arab Emirates,Kuwait,1609,1642,1,0,20,-20,1629,1622,37,56,9,-6,46,50,50,100,67
846,Dec 20 1996,Friendly tournament in Benin,Burkina Faso,Gabon,1365,1529,1,1,7,-7,1372,1522,113,72,3,-1,116,71,30,0,-164
847,Dec 21 1996,World Cup qualifier in Costa Rica,Costa Rica,Trinidad and Tobago,1568,1497,2,1,11,-11,1579,1486,63,83,0,-2,63,81,40,100,171
848,Dec 21 1996,World Cup qualifier in El Salvador,Guatemala,United States,1492,1719,2,2,11,-11,1503,1708,71,33,5,0,76,33,40,0,-227
849,Dec 21 1996,Asian Cup in the United Arab Emirates,Iran,Kuwait,1682,1622,1,1,-4,4,1678,1626,37,44,0,3,37,47,20,100,160
850,Dec 21 1996,Asian Cup in the United Arab Emirates,United Arab Emirates,Saudi Arabia,1629,1629,0,0,-7,7,1622,1636,54,44,-4,1,50,45,50,100,100
851,Dec 21 1996,Friendly in Zimbabwe,Zimbabwe,Zambia,1531,1622,2,2,0,0,1531,1622,69,50,0,0,69,50,20,100,9
852,Dec 22 1996,Friendly tournament in Benin,Benin,Gabon,1167,1522,3,3,9,-9,1176,1513,158,75,3,-2,161,73,30,100,-255
853,Dec 22 1996,Friendly tournament in Benin,Burkina Faso,Ghana,1372,1624,2,1,24,-24,1396,1600,100,64,8,-8,108,56,30,0,-252
854,Dec 24 1996,Friendly tournament in Benin,Benin,Ghana,1176,1600,1,1,11,-11,1187,1589,157,62,2,-3,159,59,30,100,-324
855,Dec 25 1996,Friendly tournament in Benin,Benin,Burkina Faso,1187,1396,1,1,5,-5,1192,1391,157,112,1,-2,158,110,20,0,-209
856,Dec 25 1996,Friendly tournament in Benin,Gabon,Ghana,1513,1589,1,1,3,-3,1516,1586,73,59,0,0,73,59,30,0,-76
857,Dec 27 1996,Friendly tournament in Benin,Benin,Burkina Faso,1192,1391,0,0,4,-4,1196,1387,158,114,0,-2,158,112,30,100,-99
858,Dec 28 1996,Friendly in Argentina,Argentina,Yugoslavia,1803,1924,2,3,-9,9,1794,1933,21,9,0,0,21,9,20,100,-21
