,date,tournament,home_team,away_team,home_team_rating,away_team_rating,home_goals,away_goals,home_team_rating_change,away_team_rating_change,home_team_new_rating,away_team_new_rating,home_team_rank,away_team_rank,home_team_rank_change,away_team_rank_change,home_team_new_rank,away_team_new_rank,k,hadv,rdiff
0,Jan 2 2011,Friendly in Qatar,China,Iraq,1628,1590,3,2,9,-9,1637,1581,53,66,1,-2,54,64,20,0,38
1,Jan 2 2011,Friendly in Qatar,Iran,Angola,1694,1459,1,0,4,-4,1698,1455,39,103,0,-2,39,101,20,0,235
2,Jan 2 2011,Friendly in the United Arab Emirates,Jordan,Uzbekistan,1469,1508,2,2,1,-1,1470,1507,94,86,1,-1,95,85,20,0,-39
3,Jan 2 2011,Friendly in the United Arab Emirates,United Arab Emirates,Syria,1473,1533,2,0,13,-13,1486,1520,91,85,1,-4,92,81,20,100,40
4,Jan 4 2011,Friendly in Bahrain,Bahrain,North Korea,1470,1527,0,1,-11,11,1459,1538,103,74,-4,2,99,76,20,100,43
5,Jan 4 2011,Friendly in Saudi Arabia,Saudi Arabia,Angola,1661,1455,0,0,-7,7,1654,1462,52,95,-3,3,49,98,20,100,306
6,Jan 5 2011,Friendly tournament in Egypt,Egypt,Tanzania,1777,1397,5,1,3,-3,1780,1394,20,114,0,-1,20,113,30,100,480
7,Jan 5 2011,Friendly tournament in Egypt,Kenya,Sudan,1275,1328,1,0,17,-17,1292,1311,132,132,3,-4,135,128,30,0,-53
8,Jan 5 2011,Friendly in the United Arab Emirates,United Arab Emirates,Australia,1486,1776,0,0,5,-5,1491,1771,92,22,0,0,92,22,20,100,-190
9,Jan 5 2011,Friendly tournament in Egypt,Uganda,Burundi,1564,1214,3,1,5,-5,1569,1209,68,154,2,-1,70,153,30,0,350
10,Jan 7 2011,Asian Cup in Qatar,Qatar,Uzbekistan,1519,1507,0,2,-49,49,1470,1556,106,63,-12,11,94,74,50,100,112
11,Jan 8 2011,Friendly tournament in Egypt,Burundi,Tanzania,1209,1394,1,1,7,-7,1216,1387,151,113,1,0,152,113,30,0,-185
12,Jan 8 2011,Asian Cup in Qatar,China,Kuwait,1637,1638,2,0,38,-38,1675,1600,32,65,11,-6,43,59,50,0,-1
13,Jan 8 2011,Friendly tournament in Egypt,DR Congo,Kenya,1396,1292,1,0,11,-11,1407,1281,106,141,3,-3,109,138,30,0,104
14,Jan 8 2011,Friendly tournament in Egypt,Egypt,Uganda,1780,1569,1,0,4,-4,1784,1565,20,74,0,-2,20,72,30,100,311
15,Jan 9 2011,Asian Cup in Qatar,Japan,Jordan,1787,1470,1,1,-18,18,1769,1488,26,90,-4,2,22,92,50,0,317
16,Jan 9 2011,Asian Cup in Qatar,Syria,Saudi Arabia,1520,1654,2,1,34,-34,1554,1620,68,60,7,-5,75,55,50,0,-134
17,Jan 10 2011,Asian Cup in Qatar,Australia,India,1771,1162,4,0,3,-3,1774,1159,21,166,0,-1,21,165,50,0,609
18,Jan 10 2011,Asian Cup in Qatar,South Korea,Bahrain,1741,1459,2,1,8,-8,1749,1451,24,105,3,-3,27,102,50,0,282
19,Jan 11 2011,Friendly tournament in Egypt,DR Congo,Sudan,1407,1311,2,1,11,-11,1418,1300,107,134,1,-3,108,131,30,0,96
20,Jan 11 2011,Friendly tournament in Egypt,Egypt,Burundi,1784,1216,3,0,1,-1,1785,1215,17,152,1,0,18,152,20,0,568
21,Jan 11 2011,Asian Cup in Qatar,Iran,Iraq,1698,1581,2,1,17,-17,1715,1564,31,78,4,-7,35,71,50,0,117
22,Jan 11 2011,Asian Cup in Qatar,North Korea,United Arab Emirates,1538,1491,0,0,-3,3,1535,1494,78,89,0,1,78,90,40,0,47
23,Jan 11 2011,Friendly tournament in Egypt,Tanzania,Uganda,1387,1565,1,1,7,-7,1394,1558,113,74,0,-1,113,73,30,0,-178
24,Jan 12 2011,Asian Cup in Qatar,Qatar,China,1470,1675,2,0,49,-49,1519,1626,71,65,12,-11,83,54,50,100,-105
25,Jan 12 2011,Asian Cup in Qatar,Uzbekistan,Kuwait,1556,1600,2,1,28,-28,1584,1572,52,79,11,-10,63,69,50,0,-44
26,Jan 13 2011,Asian Cup in Qatar,Japan,Syria,1769,1554,2,1,11,-11,1780,1543,18,79,2,-2,20,77,50,0,215
27,Jan 13 2011,Asian Cup in Qatar,Jordan,Saudi Arabia,1488,1620,1,0,34,-34,1522,1586,73,69,10,-7,83,62,50,0,-132
28,Jan 14 2011,Asian Cup in Qatar,Australia,South Korea,1774,1749,1,1,-2,2,1772,1751,22,25,0,1,22,26,50,0,25
29,Jan 14 2011,Asian Cup in Qatar,Bahrain,India,1451,1159,5,2,14,-14,1465,1145,92,175,5,-5,97,170,50,0,292
30,Jan 14 2011,CONCACAF Ch q & C Am Cup in Panama,Costa Rica,Honduras,1669,1676,1,1,0,0,1669,1676,43,42,0,0,43,42,20,0,-7
31,Jan 14 2011,Friendly tournament in Egypt,Egypt,Kenya,1785,1281,5,1,2,-2,1787,1279,18,138,0,0,18,138,20,0,504
32,Jan 14 2011,CONCACAF Ch q & C Am Cup in Panama,El Salvador,Nicaragua,1483,1075,2,0,5,-5,1488,1070,94,182,0,-2,94,180,40,0,408
33,Jan 14 2011,CONCACAF Ch q & C Am Cup in Panama,Panama,Belize,1587,1089,2,0,2,-2,1589,1087,59,176,1,0,60,176,20,0,498
34,Jan 14 2011,Friendly tournament in Egypt,Uganda,DR Congo,1558,1418,1,0,9,-9,1567,1409,68,110,3,-1,71,109,30,0,140
35,Jan 15 2011,Asian Cup in Qatar,Iran,North Korea,1715,1535,1,0,13,-13,1728,1522,31,86,2,-4,33,82,50,0,180
36,Jan 15 2011,Asian Cup in Qatar,Iraq,United Arab Emirates,1564,1494,1,0,20,-20,1584,1474,53,96,10,-2,63,94,50,0,70
37,Jan 16 2011,Asian Cup in Qatar,China,Uzbekistan,1626,1584,2,2,-3,3,1623,1587,54,61,0,1,54,62,50,0,42
38,Jan 16 2011,CONCACAF Ch q & C Am Cup in Panama,Costa Rica,Guatemala,1669,1459,2,0,14,-14,1683,1445,41,106,1,-3,42,103,40,0,210
39,Jan 16 2011,CONCACAF Ch q & C Am Cup in Panama,El Salvador,Belize,1488,1087,5,2,6,-6,1494,1081,91,176,1,0,92,176,40,0,401
40,Jan 16 2011,CONCACAF Ch q & C Am Cup in Panama,Panama,Nicaragua,1589,1070,2,0,2,-2,1591,1068,60,180,0,0,60,180,30,0,519
41,Jan 16 2011,Asian Cup in Qatar,Qatar,Kuwait,1519,1572,3,0,38,-38,1557,1534,64,88,10,-9,74,79,50,100,47
42,Jan 16 2011,Friendly tournament in Egypt,Sudan,Tanzania,1300,1394,2,0,28,-28,1328,1366,117,123,7,-5,124,118,30,0,-94
43,Jan 17 2011,Friendly tournament in Egypt,DR Congo,Kenya,1409,1279,1,0,10,-10,1419,1269,107,140,1,-1,108,139,30,0,130
44,Jan 17 2011,Friendly tournament in Egypt,Egypt,Uganda,1787,1567,3,1,6,-6,1793,1561,20,73,-1,-1,19,72,30,100,320
45,Jan 17 2011,Asian Cup in Qatar,Japan,Saudi Arabia,1780,1586,5,0,25,-25,1805,1561,14,81,3,-9,17,72,50,0,194
46,Jan 17 2011,Asian Cup in Qatar,Jordan,Syria,1522,1543,2,1,27,-27,1549,1516,71,93,6,-8,77,85,50,0,-21
47,Jan 18 2011,Asian Cup in Qatar,Australia,Bahrain,1772,1465,1,0,7,-7,1779,1458,20,101,1,-2,21,99,50,0,307
48,Jan 18 2011,CONCACAF Ch q & C Am Cup in Panama,Belize,Nicaragua,1081,1068,1,1,-1,1,1080,1069,178,180,-1,0,177,180,30,0,13
49,Jan 18 2011,CONCACAF Ch q & C Am Cup in Panama,Honduras,Guatemala,1676,1445,3,1,13,-13,1689,1432,39,109,2,-3,41,106,40,0,231
50,Jan 18 2011,CONCACAF Ch q & C Am Cup in Panama,Panama,El Salvador,1591,1494,2,0,15,-15,1606,1479,54,94,3,-1,57,93,40,100,197
51,Jan 18 2011,Asian Cup in Qatar,South Korea,India,1751,1145,4,1,3,-3,1754,1142,24,170,1,0,25,170,50,0,606
52,Jan 19 2011,Asian Cup in Qatar,Iran,United Arab Emirates,1728,1474,3,0,16,-16,1744,1458,23,102,5,-4,28,98,50,0,254
53,Jan 19 2011,Asian Cup in Qatar,Iraq,North Korea,1584,1522,1,0,21,-21,1605,1501,53,95,5,-6,58,89,50,0,62
54,Jan 19 2011,Friendly in South Africa,Sweden,Botswana,1813,1432,2,1,2,-2,1815,1430,14,108,0,-1,14,107,20,0,381
55,Jan 21 2011,CONCACAF Ch q & C Am Cup in Panama,Guatemala,Nicaragua,1432,1069,2,1,4,-4,1436,1065,102,180,2,0,104,180,40,0,363
56,Jan 21 2011,Central American Cup in Panama,Honduras,El Salvador,1689,1479,2,0,14,-14,1703,1465,39,97,1,-2,40,95,40,0,210
57,Jan 21 2011,Central American Cup in Panama,Panama,Costa Rica,1606,1683,1,1,-1,1,1605,1684,59,43,-1,0,58,43,20,100,23
58,Jan 21 2011,Asian Cup in Qatar,Qatar,Japan,1557,1805,2,3,-15,15,1542,1820,78,11,-2,3,76,14,50,100,-148
59,Jan 21 2011,Asian Cup in Qatar,Uzbekistan,Jordan,1587,1549,2,1,22,-22,1609,1527,49,83,7,-3,56,80,50,0,38
60,Jan 22 2011,Asian Cup in Qatar,Australia,Iraq,1779,1605,1,0,13,-13,1792,1592,19,66,1,-4,20,62,50,0,174
61,Jan 22 2011,Asian Cup in Qatar,South Korea,Iran,1754,1744,1,0,24,-24,1778,1720,19,42,3,-7,22,35,50,0,10
62,Jan 22 2011,Friendly in the United States,United States,Chile,1767,1893,1,1,1,-1,1768,1892,25,9,-1,0,24,9,20,100,-26
63,Jan 23 2011,Central American Cup in Panama,Honduras,Costa Rica,1703,1684,2,1,19,-19,1722,1665,28,47,6,-2,34,45,40,0,19
64,Jan 23 2011,Central American Cup in Panama,Panama,El Salvador,1605,1465,0,0,-12,12,1593,1477,62,91,-2,2,60,93,40,100,240
65,Jan 24 2011,Friendly in Vanuatu,Vanuatu,New Caledonia,1229,1289,0,0,-1,1,1228,1290,151,136,-1,0,150,136,20,100,40
66,Jan 25 2011,Asian Cup in Qatar,Australia,Uzbekistan,1792,1609,6,0,27,-27,1819,1582,8,70,6,-7,14,63,50,0,183
67,Jan 25 2011,Asian Cup in Qatar,Japan,South Korea,1820,1778,2,2,-3,3,1817,1781,16,22,-1,0,15,22,50,0,42
68,Jan 28 2011,Asian Cup in Qatar,South Korea,Uzbekistan,1781,1582,3,2,12,-12,1793,1570,18,73,2,-5,20,68,50,0,199
69,Jan 29 2011,Asian Cup in Qatar,Japan,Australia,1817,1819,1,0,25,-25,1842,1794,9,24,3,-5,12,19,50,0,-2
70,Feb 6 2011,Friendly in Portugal,Poland,Moldova,1668,1469,1,0,5,-5,1673,1464,43,95,0,0,43,95,20,0,199
71,Feb 8 2011,Friendly tournament in Cyprus,Cyprus,Sweden,1552,1815,0,2,-13,13,1539,1828,78,13,-2,1,76,14,30,100,-163
72,Feb 8 2011,Friendly in Equatorial Guinea,Equatorial Guinea,Chad,1198,1229,2,0,12,-12,1210,1217,152,153,2,-2,154,151,20,100,69
73,Feb 8 2011,Friendly in Belgium,Ghana,Togo,1742,1382,4,1,4,-4,1746,1378,29,119,0,-3,29,116,20,0,360
74,Feb 8 2011,Friendly tournament in Ireland,Ireland,Wales,1739,1552,3,0,8,-8,1747,1544,25,74,3,0,28,74,30,100,287
75,Feb 8 2011,Friendly in France,Ivory Coast,Mali,1715,1523,1,0,5,-5,1720,1518,35,82,1,0,36,82,20,0,192
76,Feb 8 2011,Friendly in Peru,Peru,Panama,1629,1593,1,0,6,-6,1635,1587,52,65,0,-3,52,62,20,100,136
77,Feb 8 2011,Friendly tournament in Cyprus,Romania,Ukraine,1713,1808,2,2,4,-4,1717,1804,38,17,0,0,38,17,30,0,-95
78,Feb 9 2011,Friendly in Albania,Albania,Slovenia,1527,1693,1,2,-8,8,1519,1701,82,39,-1,1,81,40,20,100,-66
79,Feb 9 2011,Friendly in Switzerland,Argentina,Portugal,1992,1897,2,1,7,-7,1999,1890,5,12,0,-2,5,10,20,0,95
80,Feb 9 2011,Friendly in Turkey,Belarus,Kazakhstan,1666,1320,1,1,-8,8,1658,1328,50,121,-3,3,47,124,20,0,346
81,Feb 9 2011,Friendly in Belgium,Belgium,Finland,1620,1593,1,1,-4,4,1616,1597,55,57,0,1,55,58,20,100,127
82,Feb 9 2011,Asian Cup & Asian Chlg Cup q in Cambodia,Cambodia,Macao,801,670,3,1,13,-13,814,657,207,220,0,0,207,220,40,100,231
83,Feb 9 2011,Friendly in Portugal,Cape Verde,Burkina Faso,1402,1507,1,0,13,-13,1415,1494,107,96,2,-5,109,91,20,0,-105
84,Feb 9 2011,Friendly in Croatia,Croatia,Czechia,1913,1742,4,2,5,-5,1918,1737,7,31,0,0,7,31,20,100,271
85,Feb 9 2011,Friendly tournament in Cyprus,Cyprus,Romania,1539,1717,1,1,3,-3,1542,1714,74,38,1,0,75,38,30,100,-78
86,Feb 9 2011,Friendly in Denmark,Denmark,England,1733,1924,1,2,-7,7,1726,1931,36,6,-2,0,34,6,20,100,-91
87,Feb 9 2011,Friendly in El Salvador,El Salvador,Haiti,1477,1435,1,0,6,-6,1483,1429,93,109,0,-2,93,107,20,100,142
88,Feb 9 2011,Friendly in France,France,Brazil,1802,2096,1,0,15,-15,1817,2081,12,3,3,0,15,3,20,100,-194
89,Feb 9 2011,Friendly in France,Gabon,DR Congo,1564,1419,2,0,9,-9,1573,1410,61,112,5,-2,66,110,20,0,145
90,Feb 9 2011,Friendly in Cyprus,Georgia,Armenia,1506,1441,2,1,8,-8,1514,1433,81,107,3,-2,84,105,20,0,65
91,Feb 9 2011,Friendly in Germany,Germany,Italy,2067,1833,1,1,-7,7,2060,1840,4,13,0,0,4,13,20,100,334
92,Feb 9 2011,Friendly in Greece,Greece,Canada,1750,1599,1,0,4,-4,1754,1595,27,60,0,-1,27,59,20,100,251
93,Feb 9 2011,Friendly in Portugal,Guinea-Bissau,Gambia,1253,1407,3,1,21,-21,1274,1386,133,114,5,-2,138,112,20,0,-154
94,Feb 9 2011,Friendly in Honduras,Honduras,Ecuador,1722,1727,1,1,-3,3,1719,1730,40,33,-3,0,37,33,20,100,95
95,Feb 9 2011,Friendly in the United Arab Emirates,Hungary,Azerbaijan,1641,1458,2,0,8,-8,1649,1450,49,104,1,-3,50,101,20,0,183
96,Feb 9 2011,Friendly in the United Arab Emirates,Iran,Russia,1720,1827,1,0,13,-13,1733,1814,28,17,4,-1,32,16,20,0,-107
97,Feb 9 2011,Friendly in Israel,Israel,Serbia,1685,1743,0,2,-17,17,1668,1760,48,22,-3,4,45,26,20,100,42
98,Feb 9 2011,Friendly in Libya,Libya,Benin,1501,1446,3,2,6,-6,1507,1440,87,102,1,0,88,102,20,100,155
99,Feb 9 2011,Friendly in Luxembourg,Luxembourg,Slovakia,1111,1658,2,1,19,-19,1130,1639,167,56,4,-5,171,51,20,0,-547
100,Feb 9 2011,Friendly in Macedonia,Macedonia,Cameroon,1566,1649,0,1,-10,10,1556,1659,76,42,-3,4,73,46,20,100,17
101,Feb 9 2011,Friendly in Malaysia,Malaysia,Hong Kong,1242,1214,2,0,10,-10,1252,1204,142,159,2,-3,144,156,20,100,128
102,Feb 9 2011,Friendly in Malta,Malta,Switzerland,1203,1754,0,0,9,-9,1212,1745,150,34,3,-4,153,30,20,0,-551
103,Feb 9 2011,Friendly in the United States,Mexico,Bosnia and Herzegovina,1846,1627,2,0,7,-7,1853,1620,11,55,0,-1,11,54,20,0,219
104,Feb 9 2011,Friendly in Portugal,Moldova,Andorra,1464,1013,2,1,1,-1,1465,1012,95,186,0,0,95,186,20,0,451
105,Feb 9 2011,Friendly in Morocco,Morocco,Niger,1569,1308,3,0,4,-4,1573,1304,63,132,3,-1,66,131,20,100,361
106,Feb 9 2011,Friendly in Mozambique,Mozambique,Botswana,1381,1430,1,1,-1,1,1380,1431,114,105,0,1,114,106,20,100,51
107,Feb 9 2011,Friendly in Namibia,Namibia,Malawi,1292,1413,1,2,-9,9,1283,1422,139,107,-2,1,137,108,20,100,-21
108,Feb 9 2011,Friendly in the Netherlands,Netherlands,Austria,2105,1604,3,1,1,-1,2106,1603,2,57,0,0,2,57,20,100,601
109,Feb 9 2011,Friendly in Nigeria,Nigeria,Sierra Leone,1652,1296,2,1,1,-1,1653,1295,49,135,0,-1,49,134,20,100,456
110,Feb 9 2011,Asian Cup & Asian Chlg Cup q in the Philippines,Philippines,Mongolia,942,793,2,0,12,-12,954,781,191,210,0,-1,191,209,40,100,249
111,Feb 9 2011,Friendly in Portugal,Poland,Norway,1673,1809,1,0,14,-14,1687,1795,41,20,1,-2,42,18,20,0,-136
112,Feb 9 2011,Friendly in San Marino,San Marino,Liechtenstein,906,1170,0,1,-6,6,900,1176,199,161,-1,0,198,161,20,100,-164
113,Feb 9 2011,Friendly tournament in Ireland,Scotland,Northern Ireland,1658,1577,3,0,20,-20,1678,1557,40,78,3,-6,43,72,30,0,81
114,Feb 9 2011,Friendly in Senegal,Senegal,Guinea,1580,1518,3,0,10,-10,1590,1508,58,90,3,-4,61,86,20,100,162
115,Feb 9 2011,Friendly in South Africa,South Africa,Kenya,1608,1269,2,0,2,-2,1610,1267,56,141,0,-1,56,140,20,100,439
116,Feb 9 2011,Friendly in Spain,Spain,Colombia,2116,1764,1,0,1,-1,2117,1763,1,25,0,0,1,25,20,100,452
117,Feb 9 2011,Friendly in Swaziland,Swaziland,Zambia,1149,1506,0,4,-7,7,1142,1513,170,83,-1,2,169,85,20,100,-257
118,Feb 9 2011,Friendly tournament in Cyprus,Sweden,Ukraine,1828,1804,1,1,-1,1,1827,1805,14,17,0,0,14,17,20,0,24
119,Feb 9 2011,Friendly in Tanzania,Tanzania,Palestine,1366,1158,1,0,3,-3,1369,1155,118,165,0,0,118,165,20,100,308
120,Feb 9 2011,Friendly in Turkey,Turkey,South Korea,1777,1793,0,0,-2,2,1775,1795,23,16,0,2,23,18,20,100,84
121,Feb 9 2011,Friendly in Venezuela,Venezuela,Costa Rica,1705,1665,2,2,-4,4,1701,1669,40,43,0,1,40,44,20,100,140
122,Feb 10 2011,Asian Cup & Asian Chlg Cup q in Taiwan,Taiwan,Laos,922,864,5,2,20,-20,942,844,189,205,3,-1,192,204,40,100,158
123,Feb 14 2011,Friendly in Bahrain,Bahrain,Kuwait,1458,1534,0,0,-1,1,1457,1535,100,76,-1,1,99,77,20,100,24
124,Feb 16 2011,Asian Cup & Asian Chlg Cup q in Laos,Laos,Taiwan,844,942,1,1,0,0,844,942,204,192,0,0,204,192,20,100,2
125,Feb 16 2011,Asian Cup & Asian Chlg Cup q in Macao,Macao,Cambodia,657,814,3,2,23,-23,680,791,218,209,1,-1,219,208,40,100,-57
126,Mar 11 2011,Friendly in Gibraltar,Gibraltar,Faroe Islands,1126,1209,3,0,17,-17,1143,1192,166,157,3,-1,169,156,20,100,17
127,Mar 15 2011,Asian Cup & Asian Chlg Cup q in Mongolia,Mongolia,Philippines,781,954,2,1,24,-24,805,930,205,195,2,-2,207,193,40,100,-73
128,Mar 16 2011,Friendly in Argentina,Argentina,Venezuela,1999,1701,4,1,3,-3,2002,1698,5,42,0,-1,5,41,20,100,398
129,Mar 16 2011,Friendly in Botswana,Botswana,Namibia,1431,1283,1,1,-6,6,1425,1289,108,135,-1,1,107,136,20,100,248
130,Mar 17 2011,Friendly in Nepal,Nepal,Bhutan,955,598,1,0,1,-1,956,597,190,224,0,0,190,224,20,100,457
131,Mar 19 2011,Friendly in Nepal,Nepal,Bhutan,956,597,2,1,1,-1,957,596,190,224,0,0,190,224,20,100,459
132,Mar 21 2011,Asian Cup & Asian Chlg Cup q in Malaysia,India,Taiwan,1142,942,3,0,17,-17,1159,925,162,197,4,-3,166,194,40,0,200
133,Mar 21 2011,Asian Cup & Asian Chlg Cup q in the Maldives,Maldives,Cambodia,1155,791,4,0,5,-5,1160,786,165,209,0,0,165,209,40,100,464
134,Mar 21 2011,Asian Cup & Asian Chlg Cup q in Myanmar,Myanmar,Philippines,1126,930,1,1,-14,14,1112,944,177,189,-2,2,175,191,40,100,296
135,Mar 21 2011,Asian Cup & Asian Chlg Cup q in Myanmar,Palestine,Bangladesh,1155,926,2,0,13,-13,1168,913,161,195,2,0,163,195,40,0,229
136,Mar 21 2011,Asian Cup & Asian Chlg Cup q in the Maldives,Tajikistan,Kyrgyzstan,1273,1164,1,0,14,-14,1287,1150,135,173,2,-5,137,168,40,0,109
137,Mar 21 2011,Asian Cup & Asian Chlg Cup q in Malaysia,Turkmenistan,Pakistan,1372,889,3,0,4,-4,1376,885,117,201,0,0,117,201,40,0,483
138,Mar 23 2011,Asian Cup & Asian Chlg Cup q in India,Afghanistan,Bhutan,773,596,3,0,19,-19,792,577,208,228,1,-2,209,226,40,0,177
139,Mar 23 2011,Asian Cup & Asian Chlg Cup q in Malaysia,India,Pakistan,1159,885,3,1,10,-10,1169,875,162,201,2,0,164,201,40,0,274
140,Mar 23 2011,Asian Cup & Asian Chlg Cup q in the Maldives,Maldives,Kyrgyzstan,1160,1150,2,1,14,-14,1174,1136,159,174,3,-3,162,171,40,100,110
141,Mar 23 2011,Asian Cup & Asian Chlg Cup q in Myanmar,Myanmar,Bangladesh,1112,913,0,2,-51,51,1061,964,185,183,-5,6,180,189,40,100,299
142,Mar 23 2011,Asian Cup & Asian Chlg Cup q in Myanmar,Palestine,Philippines,1168,944,0,0,-11,11,1157,955,169,193,-3,-1,166,192,30,100,324
143,Mar 23 2011,Asian Cup & Asian Chlg Cup q in the Maldives,Tajikistan,Cambodia,1287,786,3,0,4,-4,1291,782,133,211,2,-1,135,210,40,0,501
144,Mar 23 2011,Asian Cup & Asian Chlg Cup q in Malaysia,Turkmenistan,Taiwan,1376,925,2,0,4,-4,1380,921,111,196,3,-1,114,195,40,0,451
145,Mar 24 2011,Friendly in Cuba,Cuba,El Salvador,1498,1483,0,1,-13,13,1485,1496,96,87,-3,3,93,90,20,100,115
146,Mar 25 2011,Asian Cup & Asian Chlg Cup q in India,Afghanistan,Bhutan,792,577,2,0,13,-13,805,564,205,230,2,-2,207,228,40,0,215
147,Mar 25 2011,European Championship qual in Austria,Austria,Belgium,1603,1616,0,2,-37,37,1566,1653,79,41,-11,7,68,48,40,100,87
148,Mar 25 2011,Friendly in China,China,New Zealand,1623,1573,1,1,-4,4,1619,1577,57,62,-2,2,55,64,20,100,150
149,Mar 25 2011,Friendly in Estonia,Estonia,Uruguay,1473,1892,2,0,26,-26,1499,1866,86,12,4,-2,90,10,20,100,-319
150,Mar 25 2011,European Championship qual in Hungary,Hungary,Netherlands,1649,2106,0,4,-9,9,1640,2115,50,2,0,0,50,2,40,100,-357
151,Mar 25 2011,Asian Cup & Asian Chlg Cup q in Malaysia,India,Turkmenistan,1169,1380,1,1,11,-11,1180,1369,156,120,4,-3,160,117,40,0,-211
152,Mar 25 2011,Friendly in Jamaica,Jamaica,Venezuela,1657,1698,0,2,-18,18,1639,1716,54,33,-3,4,51,37,20,100,59
153,Mar 25 2011,Asian Cup & Asian Chlg Cup q in the Maldives,Kyrgyzstan,Cambodia,1136,782,4,3,5,-5,1141,777,171,210,0,0,171,210,40,0,354
154,Mar 25 2011,Friendly in Lithuania,Lithuania,Poland,1589,1687,2,0,15,-15,1604,1672,52,44,5,-1,57,43,20,100,2
155,Mar 25 2011,European Championship qual in Luxembourg,Luxembourg,France,1130,1817,0,2,-2,2,1128,1819,172,15,0,0,172,15,40,100,-587
156,Mar 25 2011,Asian Cup & Asian Chlg Cup q in the Maldives,Maldives,Tajikistan,1174,1291,0,0,1,-1,1175,1290,166,135,-2,0,164,135,30,100,-17
157,Mar 25 2011,Friendly in Montenegro,Montenegro,Uzbekistan,1722,1570,1,0,4,-4,1726,1566,33,67,1,1,34,68,20,100,252
158,Mar 25 2011,Asian Cup & Asian Chlg Cup q in Myanmar,Myanmar,Palestine,1061,1157,1,3,-30,30,1031,1187,186,150,-3,8,183,158,40,100,4
159,Mar 25 2011,Asian Cup & Asian Chlg Cup q in Malaysia,Pakistan,Taiwan,875,921,2,0,34,-34,909,887,191,207,5,-6,196,201,40,0,-46
160,Mar 25 2011,Friendly in Panama,Panama,Bolivia,1587,1581,2,0,11,-11,1598,1570,53,70,5,-3,58,67,20,100,106
161,Mar 25 2011,Asian Cup & Asian Chlg Cup q in Myanmar,Philippines,Bangladesh,955,964,3,0,36,-36,991,928,184,197,4,-4,188,193,40,0,-9
162,Mar 25 2011,European Championship qual in Serbia,Serbia,Northern Ireland,1760,1557,2,1,6,-6,1766,1551,24,74,1,-1,25,73,40,100,303
163,Mar 25 2011,European Championship qual in Slovenia,Slovenia,Italy,1701,1840,0,1,-18,18,1683,1858,42,9,-1,2,41,11,40,100,-39
164,Mar 25 2011,Friendly in South Korea,South Korea,Honduras,1795,1719,4,0,10,-10,1805,1709,16,41,1,-2,17,39,20,100,176
165,Mar 25 2011,European Championship qual in Spain,Spain,Czechia,2117,1737,2,1,2,-2,2119,1735,1,31,0,0,1,31,20,0,380
166,Mar 26 2011,European Championship qual in Albania,Albania,Belarus,1519,1658,1,0,22,-22,1541,1636,71,59,5,-6,76,53,40,100,-39
167,Mar 26 2011,European Championship qual in Andorra,Andorra,Slovakia,1012,1639,0,1,-2,2,1010,1641,186,45,0,3,186,48,40,100,-527
168,Mar 26 2011,European Championship qual in Armenia,Armenia,Russia,1433,1814,0,0,13,-13,1446,1801,97,20,4,-2,101,18,40,100,-281
169,Mar 26 2011,European Championship qual in Bosnia and Herzegovina,Bosnia and Herzegovina,Romania,1620,1714,2,1,20,-20,1640,1694,46,42,4,-2,50,40,40,100,6
170,Mar 26 2011,European Championship qual in Bulgaria,Bulgaria,Switzerland,1707,1745,0,0,-4,4,1703,1749,38,28,1,1,39,29,40,100,62
171,Mar 26 2011,African Nations Cup qualifier in Burkina Faso,Burkina Faso,Namibia,1494,1289,4,0,11,-11,1505,1278,86,141,3,-2,89,139,40,100,305
172,Mar 26 2011,African Nations Cup qualifier in Cape Verde,Cape Verde,Liberia,1415,1235,4,2,10,-10,1425,1225,109,150,0,-1,109,149,40,100,280
173,Mar 26 2011,African Nations Cup qualifier in Chad,Chad,Botswana,1217,1425,0,1,-14,14,1203,1439,157,101,-3,3,154,104,40,100,-108
174,Mar 26 2011,Friendly in Spain,Colombia,Ecuador,1763,1730,2,0,14,-14,1777,1716,16,39,5,-3,21,36,20,0,33
175,Mar 26 2011,Friendly in Costa Rica,Costa Rica,China,1669,1619,2,2,-4,4,1665,1623,46,57,-1,-1,45,56,20,100,150
176,Mar 26 2011,European Championship qual in Cyprus,Cyprus,Iceland,1542,1435,0,0,-11,11,1531,1446,85,98,-5,3,80,101,40,100,207
177,Mar 26 2011,European Championship qual in Georgia,Georgia,Croatia,1514,1918,1,0,34,-34,1548,1884,64,11,10,-2,74,9,40,100,-304
178,Mar 26 2011,European Championship qual in Germany,Germany,Kazakhstan,2060,1328,4,0,1,-1,2061,1327,4,124,0,0,4,124,20,0,732
179,Mar 26 2011,African Nations Cup qualifier in Guinea-Bissau,Guinea-Bissau,Uganda,1274,1561,0,1,-10,10,1264,1571,143,64,-2,3,141,67,40,100,-187
180,Mar 26 2011,Friendly in the United Arab Emirates,Iraq,North Korea,1592,1501,2,0,11,-11,1603,1490,57,97,2,-4,59,93,20,0,91
181,Mar 26 2011,European Championship qual in Ireland,Ireland,Macedonia,1747,1556,2,1,6,-6,1753,1550,28,74,0,-1,28,73,40,100,291
182,Mar 26 2011,European Championship qual in Israel,Israel,Latvia,1668,1530,2,1,8,-8,1676,1522,41,87,2,-4,43,83,40,100,238
183,Mar 26 2011,Friendly in the United Arab Emirates,Jordan,Kuwait,1527,1535,1,1,0,0,1527,1535,82,77,-1,0,81,77,20,0,-8
184,Mar 26 2011,African Nations Cup qualifier in Kenya,Kenya,Angola,1267,1462,2,1,25,-25,1292,1437,130,113,5,-8,135,105,40,100,-95
185,Mar 26 2011,African Nations Cup qualifier in Malawi,Malawi,Togo,1422,1378,1,0,12,-12,1434,1366,106,122,1,-3,107,119,40,100,144
186,Mar 26 2011,African Nations Cup qualifier in Mali,Mali,Zimbabwe,1518,1330,1,0,6,-6,1524,1324,82,129,0,-3,82,126,40,100,288
187,Mar 26 2011,European Championship qual in Malta,Malta,Greece,1212,1754,0,1,-3,3,1209,1757,151,27,1,0,152,27,40,100,-442
188,Mar 26 2011,Friendly in the United States,Mexico,Paraguay,1853,1785,3,1,12,-12,1865,1773,10,24,1,-1,11,23,20,0,68
189,Mar 26 2011,European Championship qual in Norway,Norway,Denmark,1795,1726,1,1,-9,9,1786,1735,21,28,-1,3,20,31,40,100,169
190,Mar 26 2011,Friendly in Portugal,Portugal,Chile,1890,1892,1,1,-3,3,1887,1895,7,6,1,1,8,7,20,100,98
191,Mar 26 2011,African Nations Cup qualifier in Rwanda,Rwanda,Burundi,1364,1215,3,1,12,-12,1376,1203,115,156,2,-2,117,154,40,100,249
192,Mar 26 2011,African Nations Cup qualifier in Senegal,Senegal,Cameroon,1590,1659,1,0,18,-18,1608,1641,52,50,5,-2,57,48,30,0,-69
193,Mar 26 2011,African Nations Cup qualifier in South Africa,South Africa,Egypt,1610,1793,1,0,25,-25,1635,1768,52,29,2,-4,54,25,40,100,-83
194,Mar 26 2011,African Nations Cup qualifier in Tanzania,Tanzania,Central African Republic,1369,1246,2,1,9,-9,1378,1237,115,147,1,-1,116,146,40,100,223
195,Mar 26 2011,Friendly in the United States,United States,Argentina,1768,2002,1,1,4,-4,1772,1998,24,5,0,0,24,5,20,100,-134
196,Mar 26 2011,European Championship qual in Wales,Wales,England,1544,1931,0,2,-10,10,1534,1941,84,6,-5,0,79,6,40,100,-287
197,Mar 27 2011,African Nations Cup qualifier in Algeria,Algeria,Morocco,1464,1573,1,0,21,-21,1485,1552,92,77,2,-6,94,71,40,100,-9
198,Mar 27 2011,Friendly in England,Brazil,Scotland,2081,1678,2,0,3,-3,2084,1675,3,44,0,-1,3,43,20,0,403
199,Mar 27 2011,African Nations Cup qualifier in Congo,Congo,Ghana,1382,1746,0,3,-13,13,1369,1759,119,24,-3,3,116,27,40,100,-264
200,Mar 27 2011,African Nations Cup qualifier in the Dem Rep of the Congo,DR Congo,Mauritius,1410,1030,3,0,4,-4,1414,1026,110,184,0,0,110,184,20,0,380
201,Mar 27 2011,African Nations Cup qualifier in Ghana,Ivory Coast,Benin,1720,1440,2,1,7,-7,1727,1433,33,111,1,-4,34,107,40,0,280
202,Mar 27 2011,African Nations Cup qualifier in Madagascar,Madagascar,Guinea,1236,1508,1,1,9,-9,1245,1499,143,92,2,-3,145,89,40,100,-172
203,Mar 27 2011,African Nations Cup qualifier in Mozambique,Mozambique,Zambia,1380,1513,0,2,-27,27,1353,1540,126,69,-6,8,120,77,40,100,-33
204,Mar 27 2011,African Nations Cup qualifier in Niger,Niger,Sierra Leone,1304,1295,3,1,21,-21,1325,1274,119,144,6,-5,125,139,40,100,109
205,Mar 27 2011,African Nations Cup qualifier in Nigeria,Nigeria,Ethiopia,1653,1326,4,0,6,-6,1659,1320,46,131,0,-3,46,128,40,100,427
206,Mar 27 2011,Friendly in Sri Lanka,Sri Lanka,Tajikistan,932,1290,2,2,6,-6,938,1284,192,138,0,-1,192,137,20,100,-258
207,Mar 27 2011,Friendly in Saint Kitts and Nevis,Saint Kitts and Nevis,Grenada,1170,1300,0,0,1,-1,1171,1299,165,132,0,0,165,132,20,100,-30
208,Mar 27 2011,African Nations Cup qualifier in Sudan,Sudan,Swaziland,1328,1142,3,0,11,-11,1339,1131,119,172,2,-1,121,171,40,100,286
209,Mar 28 2011,Friendly in Guatemala,Guatemala,Bolivia,1436,1570,1,1,1,-1,1437,1569,103,67,1,0,104,67,20,100,-34
210,Mar 28 2011,African Nations Cup qualifier in Mali,Libya,Comoros,1507,862,3,0,2,-2,1509,860,85,203,1,0,86,203,40,0,645
211,Mar 29 2011,European Championship qual in Belgium,Belgium,Azerbaijan,1653,1450,4,1,10,-10,1663,1440,45,104,1,-2,46,102,40,100,303
212,Mar 29 2011,Friendly in Turkey,Canada,Belarus,1595,1636,1,0,11,-11,1606,1625,56,59,3,-3,59,56,20,0,-41
213,Mar 29 2011,Friendly in the Netherlands,Chile,Colombia,1895,1777,2,0,10,-10,1905,1767,7,27,0,-3,7,24,20,0,118
214,Mar 29 2011,Friendly in China,China,Honduras,1623,1709,3,0,17,-17,1640,1692,44,42,6,-2,50,40,20,100,14
215,Mar 29 2011,Friendly in Costa Rica,Costa Rica,Argentina,1665,1998,0,0,6,-6,1671,1992,45,5,0,0,45,5,20,100,-233
216,Mar 29 2011,Friendly in Cuba,Cuba,Panama,1485,1598,0,2,-14,14,1471,1612,96,54,-1,3,95,57,20,100,-13
217,Mar 29 2011,Friendly in Cyprus,Cyprus,Bulgaria,1531,1703,0,1,-8,8,1523,1711,85,37,-2,1,83,38,20,100,-72
218,Mar 29 2011,European Championship qual in Czechia,Czechia,Liechtenstein,1735,1176,2,0,1,-1,1736,1175,33,163,-1,0,32,163,20,0,559
219,Mar 29 2011,Friendly in the Netherlands,Ecuador,Peru,1716,1635,0,0,-2,2,1714,1637,38,52,-1,1,37,53,20,0,81
220,Mar 29 2011,Friendly in El Salvador,El Salvador,Jamaica,1496,1639,2,3,-9,9,1487,1648,95,44,-2,4,93,48,20,100,-43
221,Mar 29 2011,Friendly in England,England,Ghana,1941,1759,1,1,-7,7,1934,1766,6,23,0,2,6,25,20,100,282
222,Mar 29 2011,Friendly in Equatorial Guinea,Equatorial Guinea,Gambia,1210,1386,1,0,12,-12,1222,1374,149,118,1,-3,150,115,20,100,-76
223,Mar 29 2011,European Championship qual in Estonia,Estonia,Serbia,1499,1766,1,1,9,-9,1508,1757,85,28,2,-1,87,27,40,100,-167
224,Mar 29 2011,Friendly in France,France,Croatia,1819,1884,0,0,-1,1,1818,1885,15,9,0,0,15,9,20,100,35
225,Mar 29 2011,Friendly in Germany,Germany,Australia,2061,1794,1,2,-18,18,2043,1812,4,13,0,3,4,16,20,100,367
226,Mar 29 2011,Friendly in Greece,Greece,Poland,1757,1672,0,0,-5,5,1752,1677,28,42,0,1,28,43,20,100,185
227,Mar 29 2011,Friendly in Ireland,Ireland,Uruguay,1753,1866,2,3,-10,10,1743,1876,33,10,-2,0,31,10,20,100,-13
228,Mar 29 2011,European Championship qual in Israel,Israel,Georgia,1676,1548,1,0,8,-8,1684,1540,40,82,1,-4,41,78,40,100,228
229,Mar 29 2011,Friendly in the United Arab Emirates,Jordan,North Korea,1527,1490,1,1,-1,1,1526,1491,80,91,1,1,81,92,20,0,37
230,Mar 29 2011,Friendly in the United Arab Emirates,Kuwait,Iraq,1535,1603,1,0,12,-12,1547,1591,70,65,4,-3,74,62,20,0,-68
231,Mar 29 2011,European Championship qual in Lithuania,Lithuania,Spain,1604,2119,1,3,-5,5,1599,2124,62,1,-2,0,60,1,40,100,-415
232,Mar 29 2011,Friendly in the United States,Mexico,Venezuela,1865,1716,1,1,-4,4,1861,1720,13,36,-1,0,12,36,20,0,149
233,Mar 29 2011,European Championship qual in the Netherlands,Netherlands,Hungary,2115,1640,5,3,2,-2,2117,1638,2,54,0,-2,2,52,20,0,475
234,Mar 29 2011,Friendly in Nigeria,Nigeria,Kenya,1659,1292,3,0,2,-2,1661,1290,48,134,-1,0,47,134,20,100,467
235,Mar 29 2011,European Championship qual in Northern Ireland,Northern Ireland,Slovenia,1551,1683,0,0,2,-2,1553,1681,70,43,1,-1,71,42,40,100,-32
236,Mar 29 2011,Friendly in Oman,Oman,Tunisia,1535,1578,2,1,8,-8,1543,1570,74,69,2,-3,76,66,20,100,57
237,Mar 29 2011,Friendly in Portugal,Portugal,Finland,1887,1597,2,0,3,-3,1890,1594,8,61,0,0,8,61,20,100,390
238,Mar 29 2011,Friendly in Qatar,Qatar,Russia,1542,1801,1,1,4,-4,1546,1797,75,18,0,0,75,18,20,100,-159
239,Mar 29 2011,European Championship qual in Romania,Romania,Luxembourg,1694,1128,3,1,1,-1,1695,1127,38,172,1,0,39,172,20,0,566
240,Mar 29 2011,Friendly in Slovakia,Slovakia,Denmark,1641,1735,1,2,-10,10,1631,1745,62,29,-7,1,55,30,20,100,6
241,Mar 29 2011,Friendly in Sri Lanka,Sri Lanka,Tajikistan,938,1284,0,2,-6,6,932,1290,192,131,0,3,192,134,20,100,-246
242,Mar 29 2011,European Championship qual in Sweden,Sweden,Moldova,1827,1465,2,1,3,-3,1830,1462,14,96,0,0,14,96,30,0,362
243,Mar 29 2011,European Championship qual in Turkey,Turkey,Austria,1775,1566,2,0,9,-9,1784,1557,22,72,0,-2,22,70,40,100,309
244,Mar 29 2011,Friendly in Ukraine,Ukraine,Italy,1805,1858,0,2,-17,17,1788,1875,22,10,-3,1,19,11,20,100,47
245,Mar 29 2011,Friendly in the United States,United States,Paraguay,1772,1773,0,1,-13,13,1759,1786,28,17,-2,3,26,20,20,100,99
246,Apr 2 2011,Friendly in Grenada,Grenada,Saint Kitts and Nevis,1299,1171,0,1,-16,16,1283,1187,142,151,-5,7,137,158,20,100,228
247,Apr 3 2011,Friendly in Tahiti,Tahiti,New Caledonia,1178,1290,1,3,-14,14,1164,1304,167,131,-2,1,165,132,20,100,-12
248,Apr 6 2011,Friendly in Tahiti,Tahiti,New Caledonia,1164,1304,1,0,11,-11,1175,1293,161,134,2,-1,163,133,20,100,-40
249,Apr 7 2011,Asian Cup & Asian Chlg Cup q in Nepal,Nepal,Afghanistan,957,805,1,0,8,-8,965,797,189,209,1,-1,190,208,40,100,252
250,Apr 7 2011,Asian Cup & Asian Chlg Cup q in Nepal,North Korea,Sri Lanka,1491,932,4,0,3,-3,1494,929,90,192,1,0,91,192,40,0,559
251,Apr 9 2011,Asian Cup & Asian Chlg Cup q in Nepal,Afghanistan,Sri Lanka,797,929,1,0,27,-27,824,902,206,202,1,-5,207,197,40,0,-132
252,Apr 9 2011,Asian Cup & Asian Chlg Cup q in Nepal,Nepal,North Korea,965,1494,0,1,-3,3,962,1497,190,91,0,0,190,91,40,100,-429
253,Apr 11 2011,Asian Cup & Asian Chlg Cup q in Nepal,Nepal,Sri Lanka,962,902,0,0,-9,9,953,911,192,191,-1,3,191,194,40,100,160
254,Apr 11 2011,Asian Cup & Asian Chlg Cup q in Nepal,North Korea,Afghanistan,1497,824,2,0,1,-1,1498,823,91,207,0,0,91,207,20,0,673
255,Apr 20 2011,Friendly in Argentina,Argentina,Ecuador,1992,1714,2,2,-8,8,1984,1722,5,35,0,1,5,36,20,100,378
256,Apr 23 2011,Friendly in Mozambique,Mozambique,Tanzania,1353,1378,2,0,12,-12,1365,1366,118,121,1,-4,119,117,20,100,75
257,May 4 2011,Friendly in New Caledonia,New Caledonia,Réunion,1293,1339,2,4,-17,17,1276,1356,143,119,-5,1,138,120,20,100,54
258,May 7 2011,Friendly in Italy,Monaco,Vatican,890,705,2,1,5,-5,895,700,200,217,0,-2,200,215,20,0,185
259,May 7 2011,Friendly in New Caledonia,New Caledonia,Réunion,1276,1356,1,3,-16,16,1260,1372,144,110,-3,5,141,115,20,100,20
260,May 14 2011,Friendly in Tanzania,Tanzania,South Africa,1366,1635,0,1,-5,5,1361,1640,122,46,-2,4,120,50,20,100,-169
261,May 20 2011,Friendly in Guyana,Guyana,Barbados,1306,1256,1,0,6,-6,1312,1250,129,145,1,-1,130,144,20,100,150
262,May 22 2011,Friendly in Guyana,Guyana,Barbados,1312,1250,3,2,6,-6,1318,1244,128,146,1,-1,129,145,20,100,162
263,May 24 2011,Friendly tournament in Ireland,Ireland,Northern Ireland,1743,1553,5,0,10,-10,1753,1543,25,79,3,-4,28,75,20,0,190
264,May 25 2011,Friendly tournament in Argentina,Argentina,Paraguay,1984,1786,4,2,7,-7,1991,1779,5,24,0,-2,5,22,20,0,198
265,May 25 2011,Friendly tournament in Ireland,Scotland,Wales,1675,1534,3,1,14,-14,1689,1520,38,88,3,-4,41,84,30,0,141
266,May 25 2011,Friendly in Swaziland,Swaziland,Botswana,1131,1439,0,0,5,-5,1136,1434,171,107,0,-2,171,105,20,100,-208
267,May 26 2011,Friendly in Cuba,Cuba,Nicaragua,1471,1065,1,1,-9,9,1462,1074,95,175,0,2,95,177,20,100,506
268,May 27 2011,Friendly in Barbados,Barbados,St Vincent & Grenadines,1244,1185,0,0,-4,4,1240,1189,147,154,-1,3,146,157,20,100,159
269,May 27 2011,Friendly in Grenada,Grenada,Antigua and Barbuda,1283,1260,2,2,-3,3,1280,1263,136,141,0,0,136,141,20,100,123
270,May 27 2011,Friendly tournament in Ireland,Wales,Northern Ireland,1520,1543,2,0,24,-24,1544,1519,66,93,9,-9,75,84,30,0,-23
271,May 28 2011,Friendly in Cuba,Cuba,Nicaragua,1462,1074,2,1,1,-1,1463,1073,95,177,0,0,95,177,20,100,488
272,May 28 2011,Friendly in the United States,Ecuador,Mexico,1722,1861,1,1,4,-4,1726,1857,34,12,1,0,35,12,20,0,-139
273,May 28 2011,Friendly in Ethiopia,Ethiopia,Sudan,1320,1339,1,2,-12,12,1308,1351,134,122,-3,0,131,122,20,100,81
274,May 29 2011,Friendly in Barbados,Barbados,Guyana,1240,1318,1,1,-1,1,1239,1319,146,128,0,0,146,128,20,100,22
275,May 29 2011,Friendly in the United States,El Salvador,Honduras,1487,1692,2,2,5,-5,1492,1687,93,40,0,0,93,40,20,0,-205
276,May 29 2011,Friendly in Germany,Germany,Uruguay,2043,1876,2,1,4,-4,2047,1872,4,12,0,-1,4,11,20,100,267
277,May 29 2011,Friendly tournament in Ireland,Ireland,Scotland,1753,1689,1,0,8,-8,1761,1681,24,43,2,-1,26,42,20,0,64
278,May 29 2011,Friendly in Panama,Panama,Grenada,1612,1280,2,0,2,-2,1614,1278,57,136,0,0,57,136,20,100,432
279,May 29 2011,Friendly in Swaziland,Swaziland,Malawi,1136,1434,1,1,5,-5,1141,1429,169,109,1,-2,170,107,20,100,-198
280,May 29 2011,Friendly in Tunisia,Tunisia,Central African Republic,1570,1237,3,0,3,-3,1573,1234,62,147,2,0,64,147,20,100,433
281,Jun 1 2011,Friendly in Canada,Canada,Ecuador,1606,1726,2,2,1,-1,1607,1725,59,39,0,-2,59,37,20,100,-20
282,Jun 1 2011,Friendly in Ethiopia,Ethiopia,Sudan,1308,1351,1,1,-2,2,1306,1353,131,122,0,0,131,122,20,100,57
283,Jun 1 2011,Friendly in Guatemala,Guatemala,Venezuela,1437,1720,0,2,-8,8,1429,1728,109,31,-3,3,106,34,20,100,-183
284,Jun 1 2011,Friendly tournament in Japan,Japan,Peru,1842,1637,0,0,-11,11,1831,1648,13,42,0,6,13,48,30,100,305
285,Jun 1 2011,Friendly in the United States,Mexico,New Zealand,1857,1577,3,0,6,-6,1863,1571,12,67,0,-2,12,65,20,0,280
286,Jun 1 2011,Friendly in Nigeria,Nigeria,Argentina,1661,1991,4,1,28,-28,1689,1963,33,5,7,0,40,5,20,100,-230
287,Jun 1 2011,Friendly in Ukraine,Ukraine,Uzbekistan,1788,1566,2,0,4,-4,1792,1562,19,68,0,0,19,68,20,100,322
288,Jun 3 2011,European Championship qual in Austria,Austria,Germany,1557,2047,1,2,-4,4,1553,2051,68,4,1,0,69,4,40,100,-390
289,Jun 3 2011,European Championship qual in Belarus,Belarus,France,1625,1818,1,1,5,-5,1630,1813,54,15,1,0,55,15,20,0,-193
290,Jun 3 2011,European Championship qual in Belgium,Belgium,Turkey,1663,1784,1,1,1,-1,1664,1783,47,21,0,0,47,21,20,100,-21
291,Jun 3 2011,European Championship qual in Croatia,Croatia,Georgia,1885,1540,2,1,3,-3,1888,1537,9,80,0,-1,9,79,40,100,445
292,Jun 3 2011,European Championship qual in the Faroe Islands,Faroe Islands,Slovenia,1192,1681,0,2,-6,6,1186,1687,166,39,-5,2,161,41,40,100,-389
293,Jun 3 2011,African Nations Cup qualifier in Ghana,Ghana,Congo,1766,1369,3,1,3,-3,1769,1366,21,118,2,-1,23,117,20,0,397
294,Jun 3 2011,Friendly in Hong Kong,Hong Kong,Malaysia,1204,1252,1,1,-1,1,1203,1253,155,143,-1,0,154,143,20,100,52
295,Jun 3 2011,European Championship qual in Italy,Italy,Estonia,1875,1508,3,0,4,-4,1879,1504,10,91,0,-2,10,89,20,0,367
296,Jun 3 2011,European Championship qual in Kazakhstan,Kazakhstan,Azerbaijan,1327,1440,2,1,21,-21,1348,1419,122,116,1,-7,123,109,40,100,-13
297,Jun 3 2011,European Championship qual in Liechtenstein,Liechtenstein,Lithuania,1175,1599,2,0,52,-52,1227,1547,135,84,14,-12,149,72,40,100,-324
298,Jun 3 2011,Friendly in Luxembourg,Luxembourg,Hungary,1127,1638,0,1,-2,2,1125,1640,172,48,0,3,172,51,20,100,-411
299,Jun 3 2011,European Championship qual in Moldova,Moldova,Sweden,1462,1830,1,4,-12,12,1450,1842,102,12,-3,1,99,13,40,100,-268
300,Jun 3 2011,European Championship qual in Romania,Romania,Bosnia and Herzegovina,1695,1640,3,0,20,-20,1715,1620,37,61,1,-5,38,56,40,100,155
301,Jun 3 2011,European Championship qual in San Marino,San Marino,Finland,900,1594,0,1,-1,1,899,1595,198,59,0,1,198,60,20,100,-594
302,Jun 3 2011,Friendly in South Korea,South Korea,Serbia,1805,1757,2,1,6,-6,1811,1751,17,30,0,-1,17,29,20,100,148
303,Jun 4 2011,Friendly in Bolivia,Bolivia,Paraguay,1569,1779,0,2,-10,10,1559,1789,72,18,-3,2,69,20,20,100,-110
304,Jun 4 2011,Friendly in Brazil,Brazil,Netherlands,2084,2117,0,0,-2,2,2082,2119,3,2,0,0,3,2,20,100,67
305,Jun 4 2011,African Nations Cup qualifier in Cameroon,Cameroon,Senegal,1641,1608,0,0,-7,7,1634,1615,56,56,-3,1,53,57,40,100,133
306,Jun 4 2011,Friendly tournament in Japan,Czechia,Peru,1736,1648,0,0,-4,4,1732,1652,34,48,-1,0,33,48,30,0,88
307,Jun 4 2011,European Championship qual in England,England,Switzerland,1934,1749,2,2,-14,14,1920,1763,6,24,0,3,6,27,40,100,285
308,Jun 4 2011,European Championship qual in Greece,Greece,Malta,1752,1209,3,1,1,-1,1753,1208,30,153,-1,0,29,153,20,0,543
309,Jun 4 2011,European Championship qual in Iceland,Iceland,Denmark,1446,1745,0,2,-14,14,1432,1759,108,25,-4,3,104,28,40,100,-199
310,Jun 4 2011,European Championship qual in Latvia,Latvia,Israel,1522,1684,1,2,-16,16,1506,1700,93,37,-5,3,88,40,40,100,-62
311,Jun 4 2011,European Championship qual in Macedonia,Macedonia,Ireland,1550,1761,0,2,-21,21,1529,1782,87,18,-8,4,79,22,40,100,-111
312,Jun 4 2011,European Championship qual in Montenegro,Montenegro,Bulgaria,1726,1711,1,1,-6,6,1720,1717,38,37,-1,1,37,38,40,100,115
313,Jun 4 2011,African Nations Cup qualifier in Morocco,Morocco,Algeria,1552,1485,4,0,21,-21,1573,1464,56,94,7,0,63,94,40,100,167
314,Jun 4 2011,African Nations Cup qualifier in Namibia,Namibia,Burkina Faso,1278,1505,1,4,-23,23,1255,1528,148,72,-6,8,142,80,40,100,-127
315,Jun 4 2011,European Championship qual in Portugal,Portugal,Norway,1890,1786,1,0,9,-9,1899,1777,8,26,0,-3,8,23,40,100,204
316,Jun 4 2011,European Championship qual in Russia,Russia,Armenia,1797,1446,3,1,4,-4,1801,1442,18,100,0,0,18,100,20,0,351
317,Jun 4 2011,African Nations Cup qualifier in Sierra Leone,Sierra Leone,Niger,1274,1325,1,0,17,-17,1291,1308,128,135,5,-5,133,130,30,0,-51
318,Jun 4 2011,European Championship qual in Slovakia,Slovakia,Andorra,1631,1010,1,0,1,-1,1632,1009,54,186,0,0,54,186,20,0,621
319,Jun 4 2011,African Nations Cup qualifier in Uganda,Uganda,Guinea-Bissau,1571,1264,2,0,5,-5,1576,1259,60,142,2,-1,62,141,40,100,407
320,Jun 4 2011,Friendly in the United States,United States,Spain,1759,2124,0,4,-7,7,1752,2131,33,1,-3,0,30,1,20,100,-265
321,Jun 4 2011,African Nations Cup qualifier in Zambia,Zambia,Mozambique,1540,1365,3,0,12,-12,1552,1353,64,123,7,-2,71,121,40,100,275
322,Jun 5 2011,African Nations Cup qualifier in Angola,Angola,Kenya,1437,1290,1,0,8,-8,1445,1282,97,138,2,-2,99,136,40,100,247
323,Jun 5 2011,Friendly in Australia,Australia,New Zealand,1812,1571,3,0,4,-4,1816,1567,14,66,1,0,15,66,20,100,341
324,Jun 5 2011,African Nations Cup qualifier in Benin,Benin,Ivory Coast,1433,1727,2,6,-18,18,1415,1745,115,29,-6,3,109,32,40,100,-194
325,Jun 5 2011,African Nations Cup qualifier in Botswana,Botswana,Malawi,1434,1429,0,0,-6,6,1428,1435,110,99,-4,3,106,102,40,100,105
326,Jun 5 2011,African Nations Cup qualifier in Burundi,Burundi,Rwanda,1203,1376,3,1,36,-36,1239,1340,140,133,7,-10,147,123,40,100,-73
327,Jun 5 2011,Friendly in China,China,Uzbekistan,1640,1562,1,0,5,-5,1645,1557,52,71,-1,-2,51,69,20,100,178
328,Jun 5 2011,African Nations Cup qualifier in Central African Republic,Central African Republic,Tanzania,1234,1361,2,1,22,-22,1256,1339,137,129,5,-5,142,124,40,100,-27
329,Jun 5 2011,African Nations Cup qualifier in the Comoros,Comoros,Libya,860,1509,1,1,18,-18,878,1491,201,98,1,-6,202,92,40,100,-549
330,Jun 5 2011,CONCACAF Championship in the United States,Costa Rica,Cuba,1671,1463,5,0,23,-23,1694,1440,36,107,5,-6,41,101,50,0,208
331,Jun 5 2011,African Nations Cup qualifier in Egypt,Egypt,South Africa,1768,1640,0,0,-12,12,1756,1652,31,46,-3,2,28,48,40,100,228
332,Jun 5 2011,African Nations Cup qualifier in Ethiopia,Ethiopia,Nigeria,1306,1689,2,2,13,-13,1319,1676,123,51,4,-5,127,46,40,100,-283
333,Jun 5 2011,African Nations Cup qualifier in Guinea,Guinea,Madagascar,1499,1245,4,1,8,-8,1507,1237,82,154,4,-5,86,149,40,100,354
334,Jun 5 2011,African Nations Cup qualifier in Liberia,Liberia,Cape Verde,1225,1425,1,0,26,-26,1251,1399,140,114,5,-3,145,111,40,100,-100
335,Jun 5 2011,African Nations Cup qualifier in Mauritius,Mauritius,DR Congo,1026,1414,1,2,-6,6,1020,1420,186,104,-1,3,185,107,40,100,-288
336,Jun 5 2011,CONCACAF Championship in the United States,Mexico,El Salvador,1863,1492,5,0,11,-11,1874,1481,10,93,1,0,11,93,50,0,371
337,Jun 5 2011,Friendly in Poland,Poland,Argentina,1677,1963,2,1,15,-15,1692,1948,39,5,3,0,42,5,20,100,-186
338,Jun 5 2011,African Nations Cup qualifier in Swaziland,Swaziland,Sudan,1141,1353,1,2,-14,14,1127,1367,172,111,-1,5,171,116,40,100,-112
339,Jun 5 2011,African Nations Cup qualifier in Tunisia,Tunisia,Chad,1573,1203,5,0,5,-5,1578,1198,61,158,1,-2,62,156,40,100,470
340,Jun 5 2011,African Nations Cup qualifier in Zimbabwe,Zimbabwe,Mali,1324,1524,2,1,26,-26,1350,1498,117,96,4,-7,121,89,40,100,-100
341,Jun 6 2011,CONCACAF Championship in the United States,Guatemala,Honduras,1429,1687,0,0,16,-16,1445,1671,94,49,5,-3,99,46,50,0,-258
342,Jun 6 2011,CONCACAF Championship in the United States,Jamaica,Grenada,1648,1278,4,0,10,-10,1658,1268,46,137,2,0,48,137,50,0,370
343,Jun 6 2011,Friendly in Ukraine,Ukraine,France,1792,1813,1,4,-21,21,1771,1834,27,12,-4,2,23,14,20,100,79
344,Jun 7 2011,Friendly in Australia,Australia,Serbia,1816,1751,0,0,-4,4,1812,1755,18,29,-1,1,17,30,20,100,165
345,Jun 7 2011,Friendly in Austria,Austria,Latvia,1553,1506,3,1,9,-9,1562,1497,64,89,3,-1,67,88,20,100,147
346,Jun 7 2011,European Championship qual in Azerbaijan,Azerbaijan,Germany,1419,2051,1,3,-3,3,1416,2054,108,4,0,0,108,4,40,100,-532
347,Jun 7 2011,European Championship qual in Belarus,Belarus,Luxembourg,1630,1125,2,0,2,-2,1632,1123,55,174,0,-1,55,173,20,0,505
348,Jun 7 2011,European Championship qual in Bosnia and Herzegovina,Bosnia and Herzegovina,Albania,1620,1541,2,0,16,-16,1636,1525,52,85,2,-4,54,81,40,100,179
349,Jun 7 2011,Friendly in Brazil,Brazil,Romania,2082,1715,1,0,1,-1,2083,1714,3,39,0,0,3,39,20,100,467
350,Jun 7 2011,Friendly in Austria,Cameroon,Russia,1634,1801,0,0,4,-4,1638,1797,53,20,0,-1,53,19,20,0,-167
351,Jun 7 2011,Friendly in the United States,Ecuador,Greece,1725,1753,1,1,1,-1,1726,1752,34,33,1,-2,35,31,20,0,-28
352,Jun 7 2011,European Championship qual in the Faroe Islands,Faroe Islands,Estonia,1186,1504,2,0,47,-47,1233,1457,139,102,11,-7,150,95,40,100,-218
353,Jun 7 2011,Friendly in Gabon,Gabon,Gambia,1573,1374,0,1,-17,17,1556,1391,76,111,-6,1,70,112,20,100,299
354,Jun 7 2011,Friendly in Belgium,Ireland,Italy,1782,1879,2,0,19,-19,1801,1860,15,14,3,-2,18,12,20,0,-97
355,Jun 7 2011,Friendly tournament in Japan,Japan,Czechia,1831,1732,0,0,-8,8,1823,1740,15,32,0,1,15,33,30,100,199
356,Jun 7 2011,Friendly in Norway,Norway,Lithuania,1777,1547,1,0,3,-3,1780,1544,22,76,0,-2,22,74,20,100,330
357,Jun 7 2011,CONCACAF Championship in the United States,Panama,Guadeloupe,1614,1508,3,2,18,-18,1632,1490,52,97,3,-6,55,91,50,0,106
358,Jun 7 2011,Friendly in Paraguay,Paraguay,Bolivia,1789,1559,0,0,-7,7,1782,1566,23,64,-2,2,21,66,20,100,330
359,Jun 7 2011,European Championship qual in San Marino,San Marino,Hungary,899,1640,0,3,-2,2,897,1642,200,52,-1,0,199,52,40,100,-641
360,Jun 7 2011,Friendly in Singapore,Singapore,Maldives,1317,1175,4,0,7,-7,1324,1168,123,166,3,-1,126,165,20,100,242
361,Jun 7 2011,Friendly in South Korea,South Korea,Ghana,1811,1769,2,1,6,-6,1817,1763,15,28,1,-2,16,26,20,100,142
362,Jun 7 2011,European Championship qual in Sweden,Sweden,Finland,1842,1595,5,0,10,-10,1852,1585,13,62,0,-1,13,61,40,100,347
363,Jun 7 2011,CONCACAF Championship in the United States,United States,Canada,1752,1607,2,0,15,-15,1767,1592,18,59,6,0,24,59,50,100,245
364,Jun 7 2011,Friendly in Venezuela,Venezuela,Spain,1728,2131,0,3,-5,5,1723,2136,37,1,-1,0,36,1,20,100,-303
365,Jun 8 2011,Friendly in China,China,North Korea,1645,1498,2,0,6,-6,1651,1492,51,92,0,-3,51,89,20,100,247
366,Jun 8 2011,Friendly tournament in Uruguay,Uruguay,Netherlands,1872,2119,1,1,6,-6,1878,2113,9,2,1,0,10,2,20,0,-247
367,Jun 9 2011,CONCACAF Championship in the United States,Costa Rica,El Salvador,1694,1481,1,1,-14,14,1680,1495,47,84,-3,4,44,88,40,100,313
368,Jun 9 2011,CONCACAF Championship in the United States,Mexico,Cuba,1874,1440,5,0,8,-8,1882,1432,9,104,1,-1,10,103,50,0,434
369,Jun 9 2011,Friendly in Poland,Poland,France,1692,1834,0,1,-9,9,1683,1843,42,14,0,0,42,14,20,100,-42
370,Jun 10 2011,CONCACAF Championship in the United States,Honduras,Grenada,1671,1268,7,1,10,-10,1681,1258,40,145,3,-4,43,141,50,0,403
371,Jun 10 2011,CONCACAF Championship in the United States,Jamaica,Guatemala,1658,1445,2,0,17,-17,1675,1428,46,111,1,-6,47,105,50,0,213
372,Jun 11 2011,CONCACAF Championship in the United States,Canada,Guadeloupe,1592,1490,1,0,18,-18,1610,1472,59,92,0,0,59,92,50,0,102
373,Jun 11 2011,Friendly in Paraguay,Paraguay,Romania,1782,1714,2,0,8,-8,1790,1706,19,39,1,0,20,39,20,100,168
374,Jun 11 2011,CONCACAF Championship in the United States,United States,Panama,1767,1632,1,2,-40,40,1727,1672,44,41,-10,7,34,48,50,100,235
375,Jun 12 2011,CONCACAF Championship in the United States,El Salvador,Cuba,1495,1432,6,1,41,-41,1536,1391,68,120,10,-9,78,111,50,0,63
376,Jun 12 2011,CONCACAF Championship in the United States,Mexico,Costa Rica,1882,1680,4,1,21,-21,1903,1659,6,53,2,-4,8,49,50,0,202
377,Jun 13 2011,CONCACAF Championship in the United States,Guatemala,Grenada,1428,1258,4,0,26,-26,1454,1232,90,159,7,-9,97,150,50,0,170
378,Jun 13 2011,CONCACAF Championship in the United States,Jamaica,Honduras,1675,1681,1,0,25,-25,1700,1656,34,55,6,-6,40,49,50,0,-6
379,Jun 14 2011,CONCACAF Championship in the United States,Canada,Panama,1610,1672,1,1,4,-4,1614,1668,59,46,0,0,59,46,40,0,-62
380,Jun 14 2011,CONCACAF Championship in the United States,United States,Guadeloupe,1727,1472,1,0,6,-6,1733,1466,32,92,1,0,33,92,30,0,255
381,Jun 15 2011,World Cup qualifier in Trinidad and Tobago,Belize,Montserrat,1080,517,5,2,3,-3,1083,514,174,230,1,0,175,230,40,0,563
382,Jun 18 2011,CONCACAF Championship in the United States,Costa Rica,Honduras,1659,1656,1,1,0,0,1659,1656,48,49,0,0,48,49,20,0,3
383,Jun 18 2011,Friendly in Malaysia,Malaysia,Myanmar,1253,1031,2,0,4,-4,1257,1027,139,183,2,0,141,183,20,100,322
384,Jun 18 2011,CONCACAF Championship in the United States,Mexico,Guatemala,1903,1454,2,1,4,-4,1907,1450,6,99,1,-1,7,98,50,0,449
385,Jun 19 2011,Friendly in Anguilla,Anguilla,US Virgin Islands,568,672,0,0,0,0,568,672,226,220,0,0,226,220,20,100,-4
386,Jun 19 2011,Friendly in Chile,Chile,Estonia,1905,1457,4,0,2,-2,1907,1455,6,97,1,-1,7,96,20,100,548
387,Jun 19 2011,CONCACAF Championship in the United States,El Salvador,Panama,1536,1668,1,1,9,-9,1545,1659,70,48,4,-1,74,47,50,0,-132
388,Jun 19 2011,CONCACAF Championship in the United States,United States,Jamaica,1733,1700,2,0,24,-24,1757,1676,23,48,5,-4,28,44,50,100,133
389,Jun 20 2011,Friendly in Argentina,Argentina,Albania,1948,1525,4,0,2,-2,1950,1523,5,82,0,0,5,82,20,100,523
390,Jun 22 2011,CONCACAF Championship in the United States,Mexico,Honduras,1907,1656,2,0,14,-14,1921,1642,5,55,1,-3,6,52,50,0,251
391,Jun 22 2011,CONCACAF Championship in the United States,United States,Panama,1757,1659,1,0,12,-12,1769,1647,20,55,4,-4,24,51,50,100,198
392,Jun 23 2011,Friendly in Paraguay,Paraguay,Chile,1790,1907,0,0,0,0,1790,1907,20,8,0,0,20,8,20,100,-17
393,Jun 23 2011,Friendly tournament in Uruguay,Uruguay,Estonia,1878,1455,3,0,2,-2,1880,1453,11,98,0,-1,11,97,20,100,523
394,Jun 25 2011,Friendly in Kenya,Kenya,Sudan,1282,1367,1,2,-10,10,1272,1377,136,112,0,2,136,114,20,100,15
395,Jun 25 2011,CONCACAF Championship in the United States,United States,Mexico,1769,1921,2,4,-32,32,1737,1953,42,4,-9,1,33,5,50,100,-52
396,Jun 29 2011,World Cup qualifier in Bangladesh,Bangladesh,Pakistan,928,909,3,0,23,-23,951,886,192,204,0,-4,192,200,40,100,119
397,Jun 29 2011,World Cup qualifier in Cambodia,Cambodia,Laos,777,844,4,2,27,-27,804,817,208,210,1,-3,209,207,30,0,-67
398,Jun 29 2011,Friendly in Iraq,Iraq,Syria,1591,1516,1,2,-15,15,1576,1531,64,73,-2,6,62,79,20,100,175
399,Jun 29 2011,World Cup qualifier in Malaysia,Malaysia,Taiwan,1257,887,2,1,3,-3,1260,884,137,201,2,0,139,201,30,0,370
400,Jun 29 2011,World Cup qualifier in Mongolia,Mongolia,Myanmar,805,1027,1,0,27,-27,832,1000,200,189,4,-3,204,186,40,100,-122
401,Jun 29 2011,World Cup qualifier in Nepal,Nepal,East Timor,953,531,2,1,2,-2,955,529,191,229,0,0,191,229,20,0,422
402,Jun 29 2011,World Cup qualifier in Tajikistan,Palestine,Afghanistan,1187,823,2,0,7,-7,1194,816,156,209,2,-1,158,208,40,0,364
403,Jun 29 2011,World Cup qualifier in Sri Lanka,Sri Lanka,Philippines,911,991,1,1,-1,1,910,992,196,188,-1,0,195,188,20,100,20
404,Jun 29 2011,World Cup qualifier in Vietnam,Vietnam,Macao,1244,680,6,0,2,-2,1246,678,145,219,0,0,145,219,20,0,564
405,Jul 1 2011,Copa América in Argentina,Argentina,Bolivia,1950,1566,1,1,-22,22,1928,1588,6,54,0,6,6,60,50,100,484
406,Jul 2 2011,Copa América in Argentina,Colombia,Costa Rica,1767,1659,1,0,17,-17,1784,1642,18,55,3,-4,21,51,50,0,108
407,Jul 2 2011,Friendly in Lebanon,Lebanon,Kuwait,1222,1547,0,6,-9,9,1213,1556,155,68,-1,2,154,70,20,100,-225
408,Jul 2 2011,World Cup qualifier in Nepal,Nepal,East Timor,955,529,5,0,4,-4,959,525,191,229,0,0,191,229,40,100,526
409,Jul 2 2011,World Cup qualifier in Turks and Caicos Islands,Turks and Caicos Islands,Bahamas,826,871,0,4,-43,43,783,914,214,185,-4,9,210,194,40,100,55
410,Jul 3 2011,Copa América in Argentina,Brazil,Venezuela,2083,1723,0,0,-19,19,2064,1742,3,28,0,4,3,32,50,0,360
411,Jul 3 2011,Copa América in Argentina,Ecuador,Paraguay,1726,1790,0,0,5,-5,1731,1785,37,20,-1,0,36,20,50,0,-64
412,Jul 3 2011,World Cup qualifier in Laos,Laos,Cambodia,817,804,6,2,26,-26,843,778,202,212,2,-2,204,210,40,100,113
413,Jul 3 2011,World Cup qualifier in Macao,Macao,Vietnam,678,1246,1,7,-5,5,673,1251,221,141,-1,2,220,143,40,100,-468
414,Jul 3 2011,World Cup qualifier in Myanmar,Myanmar,Mongolia,1000,832,2,0,11,-11,1011,821,184,208,1,-2,185,206,40,100,268
415,Jul 3 2011,World Cup qualifier in Pakistan,Pakistan,Bangladesh,886,951,0,0,-2,2,884,953,203,192,-1,0,202,192,30,100,35
416,Jul 3 2011,World Cup qualifier in Palestine,Palestine,Afghanistan,1194,816,1,1,-18,18,1176,834,168,203,-5,2,163,205,40,100,478
417,Jul 3 2011,World Cup qualifier in the Philippines,Philippines,Sri Lanka,992,910,4,0,19,-19,1011,891,182,206,3,-5,185,201,40,100,182
418,Jul 3 2011,World Cup qualifier in Taiwan,Taiwan,Malaysia,884,1260,3,2,33,-33,917,1227,186,163,8,-12,194,151,40,100,-276
419,Jul 3 2011,World Cup qualifier in the US Virgin Islands,US Virgin Islands,British Virgin Islands,672,829,2,0,35,-35,707,794,206,209,7,-2,213,207,40,100,-57
420,Jul 4 2011,Copa América in Argentina,Chile,Mexico,1907,1953,2,1,28,-28,1935,1925,2,9,3,-2,5,7,50,0,-46
421,Jul 4 2011,Copa América in Argentina,Peru,Uruguay,1652,1880,1,1,14,-14,1666,1866,45,11,1,0,46,11,50,0,-228
422,Jul 5 2011,Friendly in Turkey,Syria,Jordan,1531,1526,3,1,15,-15,1546,1511,67,88,6,-3,73,85,20,0,5
423,Jul 6 2011,Copa América in Argentina,Argentina,Colombia,1928,1784,0,0,-15,15,1913,1799,10,17,-2,2,8,19,50,100,244
424,Jul 6 2011,Friendly in Lebanon,Kuwait,Oman,1556,1543,1,1,0,0,1556,1543,70,78,0,0,70,78,20,0,13
425,Jul 6 2011,Friendly in Malawi,Malawi,Namibia,1435,1255,0,1,-17,17,1418,1272,110,130,-4,6,106,136,20,100,280
426,Jul 7 2011,Copa América in Argentina,Costa Rica,Bolivia,1642,1588,2,0,32,-32,1674,1556,41,78,5,-9,46,69,50,0,54
427,Jul 7 2011,Friendly in the Solomon Islands,Solomon Islands,Vanuatu,1286,1228,2,1,6,-6,1292,1222,131,154,2,-2,133,152,20,100,158
428,Jul 8 2011,World Cup qualifier in Aruba,Aruba,Saint Lucia,906,1073,4,2,36,-36,942,1037,189,187,4,-5,193,182,40,100,-67
429,Jul 8 2011,Copa América in Argentina,Chile,Uruguay,1935,1866,1,1,-5,5,1930,1871,5,11,0,0,5,11,20,100,169
430,Jul 8 2011,World Cup qualifier in the Dominican Republic,Dominican Republic,Anguilla,1044,568,2,0,2,-2,1046,566,178,226,2,0,180,226,20,0,476
431,Jul 8 2011,Friendly in Turkey,Jordan,Yemen,1511,1311,4,0,9,-9,1520,1302,83,132,1,-1,84,131,20,0,200
432,Jul 8 2011,Copa América in Argentina,Peru,Mexico,1666,1925,1,0,41,-41,1707,1884,31,14,8,-4,39,10,50,0,-259
433,Jul 9 2011,World Cup qualifier in the Bahamas,Bahamas,Turks and Caicos Islands,914,783,6,0,18,-18,932,765,192,211,2,-1,194,210,40,100,231
434,Jul 9 2011,Copa América in Argentina,Brazil,Paraguay,2064,1785,2,2,-17,17,2047,1802,5,15,-1,3,4,18,50,0,279
435,Jul 9 2011,Friendly in Lebanon,Lebanon,Oman,1213,1543,0,1,-4,4,1209,1547,154,68,0,5,154,73,20,100,-230
436,Jul 9 2011,Friendly in the Solomon Islands,Solomon Islands,Vanuatu,1292,1222,0,0,-5,5,1287,1227,137,148,-2,2,135,150,20,100,170
437,Jul 9 2011,Copa América in Argentina,Venezuela,Ecuador,1742,1731,1,0,24,-24,1766,1707,18,40,7,-2,25,38,50,0,11
438,Jul 10 2011,World Cup qualifier in the British Virgin Islands,British Virgin Islands,US Virgin Islands,794,707,1,2,-30,30,764,737,213,209,-3,2,210,211,40,100,187
439,Jul 10 2011,Copa América in Argentina,Colombia,Bolivia,1799,1556,2,0,15,-15,1814,1541,14,87,3,-9,17,78,50,0,243
440,Jul 10 2011,World Cup qualifier in the Dominican Republic,Dominican Republic,Anguilla,1046,566,4,0,3,-3,1049,563,180,230,0,-2,180,228,30,0,480
441,Jul 10 2011,Friendly in the Maldives,Maldives,India,1168,1180,1,1,-2,2,1166,1182,165,161,0,0,165,161,20,100,88
442,Jul 11 2011,Copa América in Argentina,Argentina,Costa Rica,1913,1674,3,0,11,-11,1924,1663,5,49,1,-1,6,48,30,0,239
443,Jul 12 2011,Copa América in Argentina,Chile,Peru,1930,1707,1,0,11,-11,1941,1696,5,44,0,-3,5,41,50,0,223
444,Jul 12 2011,World Cup qualifier in Saint Lucia,Saint Lucia,Aruba,1037,942,4,2,15,-15,1052,927,176,197,3,-2,179,195,40,100,195
445,Jul 12 2011,Copa América in Argentina,Uruguay,Mexico,1871,1884,1,0,26,-26,1897,1858,7,14,2,-2,9,12,50,0,-13
446,Jul 13 2011,Copa América in Argentina,Brazil,Ecuador,2047,1707,4,2,9,-9,2056,1698,2,42,1,-2,3,40,50,0,340
447,Jul 13 2011,Friendly in Fiji,Fiji,Vanuatu,1323,1227,2,0,7,-7,1330,1220,125,156,1,-3,126,153,20,100,196
448,Jul 13 2011,Friendly tournament in Jordan,Jordan,Saudi Arabia,1520,1561,1,1,-3,3,1517,1564,86,65,-1,1,85,66,30,100,59
449,Jul 13 2011,Friendly tournament in Jordan,Kuwait,Iraq,1556,1576,2,0,24,-24,1580,1552,53,78,8,-8,61,70,30,0,-20
450,Jul 13 2011,Copa América in Argentina,Paraguay,Venezuela,1802,1766,3,3,-3,3,1799,1769,21,25,-1,0,20,25,50,0,36
451,Jul 14 2011,Friendly in Thailand,Thailand,Myanmar,1401,1011,1,0,1,-1,1402,1010,109,187,0,-1,109,186,20,100,490
452,Jul 15 2011,Friendly in Fiji,Fiji,Vanuatu,1330,1220,1,2,-15,15,1315,1235,132,143,-3,5,129,148,20,100,210
453,Jul 15 2011,Friendly in Lebanon,Oman,Syria,1547,1546,1,1,0,0,1547,1546,72,73,0,0,72,73,20,0,1
454,Jul 15 2011,Friendly in Thailand,Thailand,Myanmar,1402,1010,1,1,-9,9,1393,1019,111,184,-1,1,110,185,20,100,492
455,Jul 16 2011,Copa América in Argentina,Argentina,Uruguay,1924,1897,1,1,-9,9,1915,1906,8,7,-1,1,7,8,50,100,127
456,Jul 16 2011,Friendly tournament in Jordan,Jordan,Iraq,1517,1552,1,1,-3,3,1514,1555,85,68,0,1,85,69,30,100,65
457,Jul 16 2011,Friendly tournament in Jordan,Kuwait,Saudi Arabia,1580,1564,1,0,14,-14,1594,1550,59,76,1,-5,60,71,30,0,16
458,Jul 16 2011,Copa América in Argentina,Peru,Colombia,1696,1814,2,0,50,-50,1746,1764,23,33,9,-8,32,25,50,0,-118
459,Jul 17 2011,World Cup qualifier in Honduras,Belize,Montserrat,1083,514,3,1,2,-2,1085,512,175,230,0,0,175,230,30,0,569
460,Jul 17 2011,Copa América in Argentina,Brazil,Paraguay,2056,1799,0,0,-16,16,2040,1815,5,15,-1,2,4,17,50,0,257
461,Jul 17 2011,Friendly in Iran,Iran,Madagascar,1733,1237,1,0,1,-1,1734,1236,36,147,0,0,36,147,20,0,496
462,Jul 17 2011,Friendly in Qatar,Qatar,India,1546,1182,1,2,-19,19,1527,1201,89,153,-8,4,81,157,20,100,464
463,Jul 17 2011,Friendly in the United Arab Emirates,United Arab Emirates,Lebanon,1458,1209,6,2,4,-4,1462,1205,94,156,0,-1,94,155,20,100,349
464,Jul 17 2011,Copa América in Argentina,Venezuela,Chile,1769,1941,2,1,36,-36,1805,1905,14,11,5,-3,19,8,50,0,-172
465,Jul 18 2011,Friendly in Singapore,Singapore,Taiwan,1324,917,3,2,1,-1,1325,916,126,196,0,0,126,196,20,100,507
466,Jul 19 2011,Copa América in Argentina,Uruguay,Peru,1906,1746,2,0,21,-21,1927,1725,3,40,2,-4,5,36,50,0,160
467,Jul 20 2011,Copa América in Argentina,Paraguay,Venezuela,1815,1805,0,0,-1,1,1814,1806,17,19,0,0,17,19,40,0,10
468,Jul 23 2011,World Cup qualifier in China,China,Laos,1651,843,7,2,0,0,1651,843,50,204,0,0,50,204,20,0,808
469,Jul 23 2011,World Cup qualifier in Iran,Iran,Maldives,1734,1166,4,0,2,-2,1736,1164,37,165,-1,0,36,165,30,0,568
470,Jul 23 2011,World Cup qualifier in Iraq,Iraq,Yemen,1555,1302,2,0,7,-7,1562,1295,63,133,3,-1,66,132,40,100,353
471,Jul 23 2011,World Cup qualifier in Jordan,Jordan,Nepal,1514,959,9,0,2,-2,1516,957,85,191,0,0,85,191,20,0,555
472,Jul 23 2011,World Cup qualifier in Kuwait,Kuwait,Philippines,1594,1011,3,0,1,-1,1595,1010,60,186,0,0,60,186,20,0,583
473,Jul 23 2011,World Cup qualifier in Lebanon,Lebanon,Bangladesh,1205,953,4,0,9,-9,1214,944,151,192,2,0,153,192,40,100,352
474,Jul 23 2011,World Cup qualifier in Oman,Oman,Myanmar,1547,1019,2,0,2,-2,1549,1017,74,185,-1,0,73,185,30,0,528
475,Jul 23 2011,Copa América in Argentina,Peru,Venezuela,1725,1806,4,1,54,-54,1779,1752,10,43,13,-12,23,31,50,0,-81
476,Jul 23 2011,World Cup qualifier in Qatar,Qatar,Vietnam,1527,1251,3,0,7,-7,1534,1244,77,145,2,-1,79,144,40,100,376
477,Jul 23 2011,World Cup qualifier in Saudi Arabia,Saudi Arabia,Hong Kong,1550,1203,3,0,5,-5,1555,1198,69,156,1,0,70,156,40,100,447
478,Jul 23 2011,World Cup qualifier in Singapore,Singapore,Malaysia,1325,1227,5,3,15,-15,1340,1212,120,157,3,-3,123,154,40,100,198
479,Jul 23 2011,World Cup qualifier in Jordan,Syria,Tajikistan,1546,1290,2,1,7,-7,1553,1283,69,136,2,-1,71,135,40,0,256
480,Jul 23 2011,World Cup qualifier in Thailand,Thailand,Palestine,1393,1176,1,0,6,-6,1399,1170,108,165,1,-1,109,164,40,100,317
481,Jul 23 2011,World Cup qualifier in Turkmenistan,Turkmenistan,Indonesia,1369,1296,1,1,-9,9,1360,1305,120,130,-2,1,118,131,40,100,173
482,Jul 23 2011,World Cup qualifier in the United Arab Emirates,United Arab Emirates,India,1462,1201,3,0,8,-8,1470,1193,90,159,2,-1,92,158,40,100,361
483,Jul 23 2011,World Cup qualifier in Uzbekistan,Uzbekistan,Kyrgyzstan,1557,1141,4,0,4,-4,1561,1137,69,170,-1,0,68,170,40,100,516
484,Jul 24 2011,Friendly in Liberia,Liberia,Gambia,1251,1391,3,2,11,-11,1262,1380,137,113,3,-1,140,112,20,100,-40
485,Jul 24 2011,Copa América in Argentina,Uruguay,Paraguay,1927,1814,3,0,30,-30,1957,1784,5,23,0,-3,5,20,50,0,113
486,Jul 27 2011,Friendly in Vanuatu,Vanuatu,Solomon Islands,1235,1287,0,0,-1,1,1234,1288,148,134,0,0,148,134,20,100,48
487,Jul 28 2011,World Cup qualifier in Bangladesh,Bangladesh,Lebanon,944,1214,2,0,44,-44,988,1170,186,175,3,-11,189,164,40,100,-170
488,Jul 28 2011,World Cup qualifier in Hong Kong,Hong Kong,Saudi Arabia,1198,1555,0,5,-15,15,1183,1570,164,62,-4,4,160,66,40,100,-257
489,Jul 28 2011,World Cup qualifier in India,India,United Arab Emirates,1193,1470,2,2,9,-9,1202,1461,152,96,3,-2,155,94,40,100,-177
490,Jul 28 2011,World Cup qualifier in Indonesia,Indonesia,Turkmenistan,1305,1360,4,3,17,-17,1322,1343,123,126,4,-4,127,122,30,0,-55
491,Jul 28 2011,World Cup qualifier in the United Arab Emirates,Iraq,Yemen,1562,1295,0,0,-13,13,1549,1308,80,130,-7,1,73,131,40,0,267
492,Jul 28 2011,World Cup qualifier in Kyrgyzstan,Kyrgyzstan,Uzbekistan,1137,1561,0,3,-9,9,1128,1570,170,64,0,2,170,66,40,100,-324
493,Jul 28 2011,World Cup qualifier in Laos,Laos,China,843,1651,1,6,-1,1,842,1652,204,48,0,1,204,49,20,100,-708
494,Jul 28 2011,World Cup qualifier in Malaysia,Malaysia,Singapore,1212,1340,1,1,2,-2,1214,1338,152,129,1,-3,153,126,40,100,-28
495,Jul 28 2011,World Cup qualifier in the Maldives,Maldives,Iran,1164,1736,0,1,-2,2,1162,1738,165,34,0,1,165,35,30,100,-472
496,Jul 28 2011,World Cup qualifier in Myanmar,Myanmar,Oman,1017,1549,0,2,-5,5,1012,1554,185,69,0,2,185,71,40,100,-432
497,Jul 28 2011,World Cup qualifier in Nepal,Nepal,Jordan,957,1516,1,1,17,-17,974,1499,189,87,1,-1,190,86,40,100,-459
498,Jul 28 2011,World Cup qualifier in Palestine,Palestine,Thailand,1170,1399,2,2,7,-7,1177,1392,160,111,2,-1,162,110,40,100,-129
499,Jul 28 2011,World Cup qualifier in the Philippines,Philippines,Kuwait,1010,1595,1,2,-2,2,1008,1597,188,60,-1,0,187,60,30,100,-485
500,Jul 28 2011,World Cup qualifier in Tajikistan,Tajikistan,Syria,1283,1553,0,4,-20,20,1263,1573,143,57,-4,7,139,64,40,100,-170
501,Jul 28 2011,World Cup qualifier in Vietnam,Vietnam,Qatar,1244,1534,2,1,30,-30,1274,1504,126,91,9,-6,135,85,40,100,-190
502,Jul 29 2011,Friendly in Mauritius,Mauritius,Mayotte,1020,1125,0,2,-15,15,1005,1140,190,168,-3,2,187,170,20,100,-5
503,Jul 30 2011,Friendly in Vanuatu,Vanuatu,Solomon Islands,1234,1288,2,0,13,-13,1247,1275,142,134,3,0,145,134,20,100,46
504,Jul 31 2011,Friendly in South Africa,Botswana,Swaziland,1428,1127,2,0,5,-5,1433,1122,100,176,2,-2,102,174,20,0,301
505,Aug 4 2011,Indian Ocean Games in the Seychelles,Madagascar,Mayotte,1236,1140,1,1,-4,4,1232,1144,150,168,-1,1,149,169,30,0,96
506,Aug 4 2011,Indian Ocean Games in the Seychelles,Maldives,Mauritius,1162,1005,1,1,-6,6,1156,1011,167,183,-1,2,166,185,20,100,257
507,Aug 4 2011,Indian Ocean Games in the Seychelles,Seychelles,Comoros,1023,878,0,0,-9,9,1014,887,183,201,0,1,183,202,30,100,245
508,Aug 6 2011,Indian Ocean Games in the Seychelles,Comoros,Maldives,887,1156,2,2,10,-10,897,1146,196,170,3,-2,199,168,30,0,-269
509,Aug 6 2011,Indian Ocean Games in the Seychelles,Réunion,Madagascar,1372,1232,2,1,9,-9,1381,1223,109,153,3,-2,112,151,30,0,140
510,Aug 6 2011,Indian Ocean Games in the Seychelles,Seychelles,Mauritius,1014,1011,2,1,11,-11,1025,1000,183,189,0,-2,183,187,30,100,103
511,Aug 7 2011,Friendly in the United States,El Salvador,Venezuela,1545,1752,2,1,15,-15,1560,1737,66,39,4,-4,70,35,20,0,-207
512,Aug 8 2011,Indian Ocean Games in the Seychelles,Mayotte,Réunion,1144,1381,2,0,36,-36,1180,1345,153,130,8,-9,161,121,30,0,-237
513,Aug 9 2011,Indian Ocean Games in the Seychelles,Mauritius,Comoros,1000,897,2,0,16,-16,1016,881,181,207,3,-4,184,203,30,0,103
514,Aug 9 2011,Indian Ocean Games in the Seychelles,Seychelles,Maldives,1025,1146,5,1,30,-30,1055,1116,175,179,4,-5,179,174,30,100,-21
515,Aug 10 2011,Friendly in Albania,Albania,Montenegro,1523,1720,3,2,13,-13,1536,1707,73,39,4,-1,77,38,20,100,-97
516,Aug 10 2011,Friendly in Austria,Austria,Slovakia,1562,1632,1,2,-11,11,1551,1643,75,52,-3,2,72,54,20,100,30
517,Aug 10 2011,Friendly in Azerbaijan,Azerbaijan,Macedonia,1416,1529,0,1,-10,10,1406,1539,107,71,0,4,107,75,20,100,-13
518,Aug 10 2011,Friendly in the United Arab Emirates,Bahrain,Oman,1457,1554,1,1,3,-3,1460,1551,95,72,0,0,95,72,20,0,-97
519,Aug 10 2011,Friendly in Belarus,Belarus,Bulgaria,1632,1717,1,0,10,-10,1642,1707,54,38,1,0,55,38,20,100,15
520,Aug 10 2011,Friendly in Bolivia,Bolivia,Panama,1541,1647,1,3,-15,15,1526,1662,85,45,-4,3,81,48,20,100,-6
521,Aug 10 2011,Friendly in Bosnia and Herzegovina,Bosnia and Herzegovina,Greece,1636,1752,0,0,0,0,1636,1752,59,29,-2,1,57,30,20,100,-16
522,Aug 10 2011,Friendly in Botswana,Botswana,Kenya,1433,1272,1,0,4,-4,1437,1268,100,140,1,-2,101,138,20,100,261
523,Aug 10 2011,Friendly in China,China,Jamaica,1652,1676,1,0,8,-8,1660,1668,51,47,-1,-1,50,46,20,100,76
524,Aug 10 2011,Friendly in Costa Rica,Costa Rica,Ecuador,1663,1698,0,2,-18,18,1645,1716,58,33,-5,4,53,37,20,100,65
525,Aug 10 2011,Friendly in Cyprus,Cyprus,Moldova,1523,1450,3,2,5,-5,1528,1445,79,100,1,-1,80,99,20,100,173
526,Aug 10 2011,Friendly in France,France,Chile,1843,1905,1,1,-1,1,1842,1906,14,8,0,0,14,8,20,100,38
527,Aug 10 2011,Friendly in France,Gabon,Guinea,1556,1507,1,1,-1,1,1555,1508,69,84,1,0,70,84,20,0,49
528,Aug 10 2011,Friendly in The Gambia,Gambia,DR Congo,1380,1420,3,0,15,-15,1395,1405,108,111,2,-3,110,108,20,100,60
529,Aug 10 2011,Friendly in Germany,Germany,Brazil,2054,2040,3,2,7,-7,2061,2033,3,4,0,0,3,4,20,100,114
530,Aug 10 2011,Friendly in Portugal,Guinea-Bissau,Equatorial Guinea,1259,1222,4,1,16,-16,1275,1206,125,156,9,-2,134,154,20,0,37
531,Aug 10 2011,Friendly in the United States,Honduras,Venezuela,1642,1737,2,0,19,-19,1661,1718,46,37,3,-1,49,36,20,0,-95
532,Aug 10 2011,Friendly in Hungary,Hungary,Iceland,1642,1432,4,0,5,-5,1647,1427,52,105,0,-1,52,104,20,100,310
533,Aug 10 2011,Friendly in Ireland,Ireland,Croatia,1801,1888,0,0,0,0,1801,1888,20,10,-1,0,19,10,20,100,13
534,Aug 10 2011,Friendly in Italy,Italy,Spain,1860,2136,2,1,15,-15,1875,2121,11,1,0,0,11,1,20,100,-176
535,Aug 10 2011,Friendly in Switzerland,Ivory Coast,Israel,1745,1700,4,3,9,-9,1754,1691,26,42,3,-1,29,41,20,0,45
536,Aug 10 2011,Friendly in Japan,Japan,South Korea,1823,1817,3,0,12,-12,1835,1805,15,18,0,-1,15,17,20,100,106
537,Aug 10 2011,Friendly in Kazakhstan,Kazakhstan,Syria,1348,1573,1,1,3,-3,1351,1570,120,66,0,-1,120,65,20,100,-125
538,Aug 10 2011,Friendly in Kuwait,Kuwait,North Korea,1597,1492,0,0,-5,5,1592,1497,64,84,-2,3,62,87,20,100,205
539,Aug 10 2011,Friendly in Latvia,Latvia,Finland,1497,1585,0,2,-16,16,1481,1601,94,57,-3,2,91,59,20,100,12
540,Aug 10 2011,Friendly in Liberia,Liberia,Angola,1262,1445,0,0,2,-2,1264,1443,139,100,1,0,140,100,20,100,-83
541,Aug 10 2011,Friendly in Liechtenstein,Liechtenstein,Switzerland,1227,1763,1,2,-2,2,1225,1765,150,22,0,2,150,24,20,100,-436
542,Aug 10 2011,Friendly in Lithuania,Lithuania,Armenia,1544,1442,3,0,8,-8,1552,1434,67,103,4,-1,71,102,20,100,202
543,Aug 10 2011,Friendly in Malta,Malta,Central African Republic,1208,1256,2,1,9,-9,1217,1247,150,144,2,0,152,144,20,100,52
544,Aug 10 2011,Friendly in Niger,Niger,Togo,1308,1366,3,3,-1,1,1307,1367,133,117,-1,-1,132,116,20,100,42
545,Aug 10 2011,Friendly in Norway,Norway,Czechia,1780,1740,3,0,11,-11,1791,1729,18,37,2,-2,20,35,20,100,140
546,Aug 10 2011,European Championship qual in Northern Ireland,Northern Ireland,Faroe Islands,1519,1233,4,0,7,-7,1526,1226,79,150,2,-1,81,149,40,100,386
547,Aug 10 2011,Friendly in Poland,Poland,Georgia,1683,1537,1,0,4,-4,1687,1533,43,78,0,0,43,78,20,100,246
548,Aug 10 2011,Friendly in Portugal,Portugal,Luxembourg,1899,1123,5,0,0,0,1899,1123,9,171,0,0,9,171,20,0,776
549,Aug 10 2011,Friendly in Russia,Russia,Serbia,1797,1755,1,0,6,-6,1803,1749,17,34,1,-2,18,32,20,100,142
550,Aug 10 2011,Friendly in San Marino,San Marino,Romania,897,1706,0,1,0,0,897,1706,199,41,0,-1,199,40,20,0,-809
551,Aug 10 2011,Friendly in Scotland,Scotland,Denmark,1681,1759,2,1,9,-9,1690,1750,40,34,2,-3,42,31,20,100,22
552,Aug 10 2011,Friendly in Senegal,Senegal,Morocco,1615,1573,0,2,-21,21,1594,1594,62,56,-2,4,60,60,20,100,142
553,Aug 10 2011,Friendly in Slovenia,Slovenia,Belgium,1687,1664,0,0,-3,3,1684,1667,46,47,-2,0,44,47,20,100,123
554,Aug 10 2011,Friendly in South Africa,South Africa,Burkina Faso,1652,1528,3,0,8,-8,1660,1520,51,86,-1,-3,50,83,20,100,224
555,Aug 10 2011,Friendly in Tunisia,Tunisia,Mali,1578,1498,4,2,8,-8,1586,1490,64,93,-1,-3,63,90,20,100,180
556,Aug 10 2011,Friendly in Turkey,Turkey,Estonia,1783,1453,3,0,3,-3,1786,1450,21,97,0,0,21,97,20,100,430
557,Aug 10 2011,Friendly in Ukraine,Ukraine,Sweden,1771,1852,0,1,-11,11,1760,1863,30,11,-3,1,27,12,20,100,19
558,Aug 10 2011,Friendly in the United States,United States,Mexico,1737,1858,1,1,1,-1,1738,1857,31,14,2,-1,33,13,20,100,-21
559,Aug 10 2011,Friendly in Wales,Wales,Australia,1544,1812,1,2,-6,6,1538,1818,77,15,-1,1,76,16,20,100,-168
560,Aug 10 2011,Friendly in Zimbabwe,Zimbabwe,Zambia,1350,1552,2,0,19,-19,1369,1533,111,83,4,-5,115,78,20,100,-102
561,Aug 11 2011,Indian Ocean Games in the Seychelles,Mauritius,Mayotte,1016,1180,0,0,7,-7,1023,1173,184,167,0,-3,184,164,30,0,-164
562,Aug 11 2011,Indian Ocean Games in the Seychelles,Seychelles,Réunion,1055,1345,2,1,22,-22,1077,1323,175,131,2,-5,177,126,30,100,-190
563,Aug 13 2011,Indian Ocean Games in the Seychelles,Réunion,Mayotte,1323,1173,1,0,9,-9,1332,1164,126,166,0,-1,126,165,30,0,150
564,Aug 13 2011,Indian Ocean Games in the Seychelles,Seychelles,Mauritius,1077,1023,1,1,-6,6,1071,1029,179,184,-1,0,178,184,30,100,154
565,Aug 14 2011,Friendly in Liberia,Liberia,Niger,1264,1307,0,0,-2,2,1262,1309,144,130,-2,1,142,131,20,100,57
566,Aug 17 2011,Friendly in Fiji,Fiji,Samoa,1315,702,3,0,1,-1,1316,701,130,214,0,0,130,214,20,0,613
567,Aug 17 2011,Friendly in Lebanon,Lebanon,Syria,1170,1570,2,3,-3,3,1167,1573,164,65,0,0,164,65,20,100,-300
568,Aug 18 2011,Friendly in Fiji,Fiji,Samoa,1316,701,5,1,1,-1,1317,700,130,216,0,-1,130,215,20,0,615
569,Aug 19 2011,Friendly in Eritrea,Eritrea,Sudan,1179,1377,0,3,-13,13,1166,1390,167,112,-3,1,164,113,20,100,-98
570,Aug 19 2011,Friendly in Qatar,Qatar,Iraq,1504,1549,0,1,-12,12,1492,1561,91,64,-3,5,88,69,20,100,55
571,Aug 20 2011,Friendly in the Dominican Republic,Dominican Republic,Curaçao,1049,1123,1,0,9,-9,1058,1114,178,177,2,-3,180,174,20,100,26
572,Aug 20 2011,Friendly in Lesotho,Lesotho,Swaziland,1162,1122,0,0,-4,4,1158,1126,166,169,0,2,166,171,20,100,140
573,Aug 21 2011,Friendly in Barbados,Barbados,Saint Lucia,1239,1052,4,0,6,-6,1245,1046,146,183,0,-1,146,182,20,100,287
574,Aug 21 2011,Friendly in the Dominican Republic,Dominican Republic,Curaçao,1058,1114,1,0,9,-9,1067,1105,180,174,0,0,180,174,20,100,44
575,Aug 21 2011,Friendly in Trinidad and Tobago,Trinidad and Tobago,India,1494,1202,3,0,3,-3,1497,1199,85,155,1,0,86,155,20,100,392
576,Aug 22 2011,Friendly in Indonesia,Indonesia,Palestine,1322,1177,4,1,7,-7,1329,1170,127,163,0,-1,127,162,20,100,245
577,Aug 22 2011,Friendly in Jordan,Jordan,Tunisia,1499,1586,3,3,0,0,1499,1586,85,63,0,0,85,63,20,100,13
578,Aug 22 2011,Friendly in Lesotho,Lesotho,Swaziland,1158,1126,0,1,-14,14,1144,1140,170,169,-2,1,168,170,20,100,132
579,Aug 22 2011,Friendly in Fiji,Tuvalu,Samoa,721,700,3,0,16,-16,737,684,209,223,2,-4,211,219,20,0,21
580,Aug 24 2011,Friendly in Guyana,Guyana,India,1319,1199,2,1,4,-4,1323,1195,128,157,0,-1,128,156,20,100,220
581,Aug 24 2011,Friendly in Thailand,Thailand,Singapore,1392,1338,0,0,-4,4,1388,1342,115,119,-2,3,113,122,20,100,154
582,Aug 25 2011,Friendly in the United Arab Emirates,United Arab Emirates,Qatar,1461,1492,3,1,12,-12,1473,1480,90,94,2,-3,92,91,20,100,69
583,Aug 26 2011,Friendly in Antigua and Barbuda,Antigua and Barbuda,St Vincent & Grenadines,1263,1189,1,0,5,-5,1268,1184,136,161,2,-2,138,159,20,100,174
584,Aug 26 2011,Friendly in Bahrain,Bahrain,Sudan,1460,1390,1,0,5,-5,1465,1385,93,114,1,-1,94,113,20,100,170
585,Aug 27 2011,Friendly in Angola,Angola,DR Congo,1443,1405,1,2,-14,14,1429,1419,104,102,-2,3,102,105,20,100,138
586,Aug 27 2011,Pacific Games in New Caledonia,Fiji,Tahiti,1317,1175,3,0,21,-21,1338,1154,122,169,4,-4,126,165,40,0,142
587,Aug 27 2011,Friendly in Jordan,Jordan,Indonesia,1499,1329,1,0,3,-3,1502,1326,85,129,0,-1,85,128,20,100,270
588,Aug 27 2011,Pacific Games in New Caledonia,New Caledonia,Vanuatu,1260,1247,5,0,27,-27,1287,1220,125,158,9,-7,134,151,40,100,113
589,Aug 27 2011,Friendly in Oman,Oman,Kuwait,1551,1592,1,0,8,-8,1559,1584,69,64,2,-1,71,63,20,100,59
590,Aug 27 2011,Pacific Games in New Caledonia,Papua New Guinea,Cook Islands,1045,726,4,0,10,-10,1055,716,179,213,2,0,181,213,40,0,319
591,Aug 27 2011,Pacific Games in New Caledonia,Solomon Islands,Guam,1275,600,7,0,2,-2,1277,598,136,223,-1,0,135,223,40,0,675
592,Aug 27 2011,Pacific Games in New Caledonia,Tuvalu,Eastern Samoa,737,354,4,0,7,-7,744,347,211,234,0,0,211,234,40,0,383
593,Aug 28 2011,Friendly in Antigua and Barbuda,Antigua and Barbuda,St Vincent & Grenadines,1268,1184,2,2,-5,5,1263,1189,143,155,-2,2,141,157,20,100,184
594,Aug 30 2011,Friendly in Botswana,Botswana,Lesotho,1437,1144,1,2,-18,18,1419,1162,108,162,-4,3,104,165,20,100,393
595,Aug 30 2011,Pacific Games in New Caledonia,Fiji,Kiribati,1338,579,9,0,1,-1,1339,578,122,225,2,0,124,225,20,0,759
596,Aug 30 2011,Pacific Games in New Caledonia,New Caledonia,Guam,1287,598,9,0,1,-1,1288,597,134,223,0,0,134,223,20,0,689
597,Aug 30 2011,Pacific Games in New Caledonia,Solomon Islands,Eastern Samoa,1277,347,4,0,0,0,1277,347,135,234,0,0,135,234,20,0,930
598,Aug 30 2011,Pacific Games in New Caledonia,Tahiti,Cook Islands,1154,716,7,0,7,-7,1161,709,167,213,-1,0,166,213,40,0,438
599,Aug 30 2011,Pacific Games in New Caledonia,Vanuatu,Tuvalu,1220,744,5,1,5,-5,1225,739,147,211,2,0,149,211,40,0,476
600,Sep 1 2011,Pacific Games in New Caledonia,Cook Islands,Kiribati,709,578,3,0,22,-22,731,556,213,231,0,-3,213,228,40,0,131
601,Sep 1 2011,Pacific Games in New Caledonia,Guam,Eastern Samoa,597,347,2,0,12,-12,609,335,223,234,0,0,223,234,40,0,250
602,Sep 1 2011,Pacific Games in New Caledonia,New Caledonia,Tuvalu,1288,739,8,0,2,-2,1290,737,134,211,0,0,134,211,20,0,549
603,Sep 1 2011,Pacific Games in New Caledonia,Papua New Guinea,Tahiti,1055,1161,1,1,6,-6,1061,1155,181,166,0,0,181,166,40,0,-106
604,Sep 1 2011,Pacific Games in New Caledonia,Vanuatu,Solomon Islands,1225,1277,1,0,23,-23,1248,1254,139,151,5,-8,144,143,40,0,-52
605,Sep 2 2011,European Championship qual in Albania,Albania,France,1536,1842,1,2,-9,9,1527,1851,81,12,-2,1,79,13,40,100,-206
606,Sep 2 2011,European Championship qual in Andorra,Andorra,Armenia,1009,1434,0,3,-9,9,1000,1443,190,98,-2,1,188,99,40,100,-325
607,Sep 2 2011,World Cup qualifier in Antigua and Barbuda,Antigua and Barbuda,Curaçao,1263,1105,5,2,13,-13,1276,1092,130,178,5,-2,135,176,40,100,258
608,Sep 2 2011,Friendly tournament in India,Argentina,Venezuela,1915,1718,1,0,7,-7,1922,1711,7,38,0,-1,7,37,30,0,197
609,Sep 2 2011,World Cup qualifier in Australia,Australia,Thailand,1818,1388,2,1,2,-2,1820,1386,16,112,0,0,16,112,20,0,430
610,Sep 2 2011,European Championship qual in Azerbaijan,Azerbaijan,Belgium,1406,1667,1,1,9,-9,1415,1658,106,55,1,-4,107,51,40,100,-161
611,Sep 2 2011,World Cup qualifier in Bahrain,Bahrain,Qatar,1465,1480,0,0,-5,5,1460,1485,96,91,-1,0,95,91,40,100,85
612,Sep 2 2011,European Championship qual in Belarus,Belarus,Bosnia and Herzegovina,1642,1636,0,2,-39,39,1603,1675,63,31,-4,13,59,44,40,100,106
613,Sep 2 2011,European Championship qual in Bulgaria,Bulgaria,England,1707,1920,0,3,-24,24,1683,1944,44,6,-3,0,41,6,40,100,-113
614,Sep 2 2011,World Cup qualifier in Canada,Canada,Saint Lucia,1614,1046,4,1,1,-1,1615,1045,56,181,1,1,57,182,20,0,568
615,Sep 2 2011,World Cup qualifier in China,China,Singapore,1660,1342,2,1,3,-3,1663,1339,44,124,3,-1,47,123,20,0,318
616,Sep 2 2011,European Championship qual in Cyprus,Cyprus,Portugal,1528,1899,0,4,-13,13,1515,1912,84,7,-2,1,82,8,40,100,-271
617,Sep 2 2011,World Cup qualifier in Dominica,Dominica,Nicaragua,1081,1073,0,2,-39,39,1042,1112,190,173,-7,2,183,175,40,100,108
618,Sep 2 2011,Friendly in Ecuador,Ecuador,Jamaica,1716,1668,5,2,10,-10,1726,1658,33,56,2,-5,35,51,20,100,148
619,Sep 2 2011,World Cup qualifier in El Salvador,El Salvador,Dominican Republic,1560,1067,3,2,1,-1,1561,1066,70,178,0,1,70,179,20,0,493
620,Sep 2 2011,European Championship qual in the Faroe Islands,Faroe Islands,Italy,1226,1875,0,1,-2,2,1224,1877,149,11,0,0,149,11,40,100,-549
621,Sep 2 2011,European Championship qual in Finland,Finland,Moldova,1601,1445,4,1,13,-13,1614,1432,57,101,1,-1,58,100,40,100,256
622,Sep 2 2011,European Championship qual in Georgia,Georgia,Latvia,1533,1481,0,1,-28,28,1505,1509,94,78,-8,6,86,84,40,100,152
623,Sep 2 2011,European Championship qual in Germany,Germany,Austria,2061,1551,6,2,2,-2,2063,1549,3,72,0,1,3,73,20,0,510
624,Sep 2 2011,African Nations Cup qualifier in Ghana,Ghana,Swaziland,1763,1140,2,0,1,-1,1764,1139,26,172,0,-1,26,171,20,0,623
625,Sep 2 2011,World Cup qualifier in Grenada,Grenada,Belize,1232,1085,0,3,-56,56,1176,1141,170,165,-11,5,159,170,40,100,247
626,Sep 2 2011,World Cup qualifier in Guatemala,Guatemala,St Vincent & Grenadines,1450,1189,4,0,8,-8,1458,1181,95,159,1,-1,96,158,40,100,361
627,Sep 2 2011,World Cup qualifier in Guyana,Guyana,Barbados,1323,1245,2,0,16,-16,1339,1229,117,150,6,-2,123,148,40,100,178
628,Sep 2 2011,World Cup qualifier in Haiti,Haiti,US Virgin Islands,1429,737,6,0,1,-1,1430,736,101,213,0,-1,101,212,20,0,692
629,Sep 2 2011,European Championship qual in Hungary,Hungary,Sweden,1647,1863,2,1,26,-26,1673,1837,38,18,7,-3,45,15,40,100,-116
630,Sep 2 2011,World Cup qualifier in Iran,Iran,Indonesia,1738,1326,3,0,3,-3,1741,1323,33,130,0,-1,33,129,20,0,412
631,Sep 2 2011,World Cup qualifier in Iraq,Iraq,Jordan,1561,1502,0,2,-43,43,1518,1545,93,63,-12,11,81,74,40,100,159
632,Sep 2 2011,European Championship qual in Ireland,Ireland,Slovakia,1801,1643,0,0,-13,13,1788,1656,23,52,-2,1,21,53,40,100,258
633,Sep 2 2011,European Championship qual in Israel,Israel,Greece,1691,1752,0,1,-22,22,1669,1774,51,16,-5,7,46,23,40,100,39
634,Sep 2 2011,World Cup qualifier in Japan,Japan,North Korea,1835,1497,1,0,3,-3,1838,1494,13,90,1,-2,14,88,20,0,338
635,Sep 2 2011,European Championship qual in Lithuania,Lithuania,Liechtenstein,1552,1225,0,0,-17,17,1535,1242,77,142,-2,4,75,146,40,100,427
636,Sep 2 2011,European Championship qual in Luxembourg,Luxembourg,Romania,1123,1706,0,2,-4,4,1119,1710,174,36,-1,2,173,38,40,100,-483
637,Sep 2 2011,European Championship qual in Malta,Malta,Croatia,1217,1888,1,3,-2,2,1215,1890,150,10,1,0,151,10,30,100,-571
638,Sep 2 2011,European Championship qual in the Netherlands,Netherlands,San Marino,2113,897,11,0,0,0,2113,897,2,199,0,0,2,199,20,0,1216
639,Sep 2 2011,European Championship qual in Norway,Norway,Iceland,1791,1427,1,0,3,-3,1794,1424,20,103,0,0,20,103,30,0,364
640,Sep 2 2011,European Championship qual in Northern Ireland,Northern Ireland,Serbia,1526,1749,0,1,-13,13,1513,1762,85,24,-2,4,83,28,40,100,-123
641,Sep 2 2011,World Cup qualifier in Oman,Oman,Saudi Arabia,1559,1570,0,0,-5,5,1554,1575,73,66,-1,0,72,66,40,100,89
642,Sep 2 2011,Friendly in Panama,Panama,Paraguay,1662,1784,0,2,-14,14,1648,1798,62,16,-7,3,55,19,20,100,-22
643,Sep 2 2011,Friendly in Peru,Peru,Bolivia,1779,1526,2,2,-8,8,1771,1534,25,73,-1,4,24,77,20,100,353
644,Sep 2 2011,Friendly in Poland,Poland,Mexico,1687,1857,1,1,2,-2,1689,1855,37,11,3,1,40,12,20,100,-70
645,Sep 2 2011,European Championship qual in Russia,Russia,Macedonia,1803,1539,1,0,4,-4,1807,1535,16,75,1,0,17,75,20,0,264
646,Sep 2 2011,European Championship qual in Slovenia,Slovenia,Estonia,1684,1450,1,2,-35,35,1649,1485,64,85,-10,6,54,91,40,100,334
647,Sep 2 2011,World Cup qualifier in South Korea,South Korea,Lebanon,1805,1167,6,0,1,-1,1806,1166,19,162,-1,0,18,162,20,0,638
648,Sep 2 2011,Friendly in Switzerland,Spain,Chile,2121,1906,3,2,4,-4,2125,1902,1,10,0,-1,1,9,20,0,215
649,Sep 2 2011,World Cup qualifier in Saint Kitts and Nevis,Saint Kitts and Nevis,Puerto Rico,1187,995,0,0,-14,14,1173,1009,161,184,-1,2,160,186,40,100,292
650,Sep 2 2011,World Cup qualifier in Suriname,Suriname,Cayman Islands,1267,961,1,0,4,-4,1271,957,139,192,0,0,139,192,30,0,306
651,Sep 2 2011,World Cup qualifier in Tajikistan,Tajikistan,Uzbekistan,1263,1570,0,1,-9,9,1254,1579,144,62,-2,2,142,64,40,100,-207
652,Sep 2 2011,World Cup qualifier in Trinidad and Tobago,Trinidad and Tobago,Bermuda,1497,1153,1,0,3,-3,1500,1150,88,167,-1,0,87,167,40,100,444
653,Sep 2 2011,European Championship qual in Turkey,Turkey,Kazakhstan,1786,1351,2,1,2,-2,1788,1349,21,120,0,0,21,120,20,0,435
654,Sep 2 2011,World Cup qualifier in the United Arab Emirates,United Arab Emirates,Kuwait,1473,1584,2,3,-19,19,1454,1603,102,55,-5,4,97,59,40,100,-11
655,Sep 2 2011,Friendly in Ukraine,Ukraine,Uruguay,1760,1957,2,3,-7,7,1753,1964,35,5,-4,0,31,5,20,100,-97
656,Sep 2 2011,Friendly in the United States,United States,Costa Rica,1738,1645,0,1,-15,15,1723,1660,39,45,-3,4,36,49,20,100,193
657,Sep 2 2011,European Championship qual in Wales,Wales,Montenegro,1538,1707,2,1,24,-24,1562,1683,62,44,7,-3,69,41,40,100,-69
658,Sep 3 2011,Friendly in Burkina Faso,Burkina Faso,Equatorial Guinea,1520,1206,1,0,2,-2,1522,1204,80,153,0,0,80,153,20,100,414
659,Sep 3 2011,African Nations Cup qualifier in Cameroon,Cameroon,Mauritius,1638,1029,5,0,1,-1,1639,1028,56,184,0,0,56,184,20,0,609
660,Sep 3 2011,Friendly in the United States,Colombia,Honduras,1764,1661,2,0,11,-11,1775,1650,20,58,3,-5,23,53,20,0,103
661,Sep 3 2011,Pacific Games in New Caledonia,Fiji,Cook Islands,1339,731,4,1,2,-2,1341,729,119,213,2,0,121,213,30,0,608
662,Sep 3 2011,African Nations Cup qualifier in Kenya,Kenya,Guinea-Bissau,1268,1275,2,1,15,-15,1283,1260,132,146,4,-5,136,141,30,0,-7
663,Sep 3 2011,African Nations Cup qualifier in Egypt,Libya,Mozambique,1491,1353,1,0,12,-12,1503,1341,87,123,1,-2,88,121,40,0,138
664,Sep 3 2011,African Nations Cup qualifier in Malawi,Malawi,Tunisia,1418,1586,0,0,4,-4,1422,1582,102,63,2,0,104,63,20,0,-168
665,Sep 3 2011,African Nations Cup qualifier in Mali,Mali,Cape Verde,1490,1399,3,0,17,-17,1507,1382,82,115,4,-3,86,112,40,100,191
666,Sep 3 2011,African Nations Cup qualifier in Namibia,Namibia,Gambia,1272,1395,1,0,21,-21,1293,1374,130,118,4,-4,134,114,40,100,-23
667,Sep 3 2011,Pacific Games in New Caledonia,New Caledonia,Eastern Samoa,1290,335,8,0,0,0,1290,335,136,234,-1,0,135,234,20,0,955
668,Sep 3 2011,Pacific Games in New Caledonia,Papua New Guinea,Kiribati,1061,556,17,1,7,-7,1068,549,178,228,1,0,179,228,40,0,505
669,Sep 3 2011,African Nations Cup qualifier in Rwanda,Rwanda,Ivory Coast,1340,1754,0,5,-11,11,1329,1765,134,22,-6,4,128,26,40,100,-314
670,Sep 3 2011,European Championship qual in Scotland,Scotland,Czechia,1690,1729,2,2,-3,3,1687,1732,41,32,-1,1,40,33,30,100,61
671,Sep 3 2011,African Nations Cup qualifier in Senegal,Senegal,DR Congo,1594,1419,2,0,10,-10,1604,1409,57,112,2,-4,59,108,40,100,275
672,Sep 3 2011,African Nations Cup qualifier in Sierra Leone,Sierra Leone,Egypt,1291,1756,2,1,36,-36,1327,1720,125,43,4,-7,129,36,40,100,-365
673,Sep 3 2011,Pacific Games in New Caledonia,Solomon Islands,Tuvalu,1254,737,6,1,4,-4,1258,733,142,213,0,-1,142,212,40,0,517
674,Sep 3 2011,African Nations Cup qualifier in Tanzania,Tanzania,Algeria,1339,1464,1,1,1,-1,1340,1463,123,94,0,0,123,94,20,100,-25
675,Sep 3 2011,Pacific Games in New Caledonia,Vanuatu,Guam,1248,609,4,1,2,-2,1250,607,144,223,0,0,144,223,40,0,639
676,Sep 4 2011,African Nations Cup qualifier in Angola,Angola,Uganda,1429,1576,2,0,34,-34,1463,1542,86,83,8,-9,94,74,40,100,-47
677,Sep 4 2011,African Nations Cup qualifier in Burundi,Burundi,Benin,1239,1415,1,1,4,-4,1243,1411,145,106,1,0,146,106,40,100,-76
678,Sep 4 2011,African Nations Cup qualifier in Central African Republic,Central African Republic,Morocco,1247,1594,0,0,12,-12,1259,1582,137,62,4,0,141,62,40,100,-247
679,Sep 4 2011,African Nations Cup qualifier in the Comoros,Comoros,Zambia,881,1533,1,2,-2,2,879,1535,203,72,0,3,203,75,40,100,-552
680,Sep 4 2011,African Nations Cup qualifier in Congo,Congo,Sudan,1366,1385,0,1,-25,25,1341,1410,123,103,-3,4,120,107,40,100,81
681,Sep 4 2011,African Nations Cup qualifier in Guinea,Guinea,Ethiopia,1508,1319,1,0,6,-6,1514,1313,81,133,2,-1,83,132,40,100,289
682,Sep 4 2011,African Nations Cup qualifier in Madagascar,Madagascar,Nigeria,1223,1676,0,2,-7,7,1216,1683,150,39,0,2,150,41,40,100,-353
683,Sep 4 2011,Friendly in Spain,Mexico,Chile,1855,1902,1,0,11,-11,1866,1891,12,9,0,0,12,9,20,0,-47
684,Sep 4 2011,African Nations Cup qualifier in Niger,Niger,South Africa,1309,1660,2,1,32,-32,1341,1628,108,64,12,-8,120,56,40,100,-251
685,Sep 4 2011,African Nations Cup qualifier in Togo,Togo,Botswana,1367,1419,1,0,17,-17,1384,1402,110,113,3,-4,113,109,30,0,-52
686,Sep 4 2011,African Nations Cup qualifier in Zimbabwe,Zimbabwe,Liberia,1369,1262,3,0,16,-16,1385,1246,109,150,3,-5,112,145,40,100,207
687,Sep 5 2011,Friendly in Bolivia,Bolivia,Peru,1534,1771,0,0,4,-4,1538,1767,72,25,3,0,75,25,20,100,-137
688,Sep 5 2011,Friendly in England,Brazil,Ghana,2033,1764,1,0,4,-4,2037,1760,4,30,0,-1,4,29,20,0,269
689,Sep 5 2011,Pacific Games in New Caledonia,Fiji,Papua New Guinea,1341,1068,2,0,10,-10,1351,1058,116,181,2,-1,118,180,40,0,273
690,Sep 5 2011,Pacific Games in New Caledonia,Guam,Tuvalu,607,733,1,1,7,-7,614,726,223,214,0,-1,223,213,40,0,-126
691,Sep 5 2011,Pacific Games in New Caledonia,New Caledonia,Solomon Islands,1290,1258,1,2,-27,27,1263,1285,145,128,-5,7,140,135,40,100,132
692,Sep 5 2011,Pacific Games in New Caledonia,Tahiti,Kiribati,1155,549,17,1,4,-4,1159,545,166,228,0,0,166,228,40,0,606
693,Sep 5 2011,Pacific Games in New Caledonia,Vanuatu,Eastern Samoa,1250,335,8,0,0,0,1250,335,144,234,0,0,144,234,20,0,915
694,Sep 6 2011,Friendly in Bangladesh,Argentina,Nigeria,1922,1683,3,1,6,-6,1928,1677,7,47,0,-3,7,44,20,0,239
695,Sep 6 2011,European Championship qual in Austria,Austria,Turkey,1549,1788,0,0,8,-8,1557,1780,70,25,1,-2,71,23,40,100,-139
696,Sep 6 2011,European Championship qual in Azerbaijan,Azerbaijan,Kazakhstan,1415,1349,3,2,11,-11,1426,1338,101,131,2,-6,103,125,40,100,166
697,Sep 6 2011,World Cup qualifier in Barbados,Barbados,Trinidad and Tobago,1229,1500,0,2,-16,16,1213,1516,156,73,-4,8,152,81,40,100,-171
698,Sep 6 2011,Friendly in Belgium,Belgium,United States,1658,1723,1,0,9,-9,1667,1714,41,37,4,-1,45,36,20,100,35
699,Sep 6 2011,World Cup qualifier in Belize,Belize,Guatemala,1141,1458,1,2,-9,9,1132,1467,174,93,-2,2,172,95,40,100,-217
700,Sep 6 2011,European Championship qual in Bosnia and Herzegovina,Bosnia and Herzegovina,Belarus,1675,1603,1,0,11,-11,1686,1592,40,60,2,0,42,60,40,100,172
701,Sep 6 2011,World Cup qualifier in the Cayman Islands,Cayman Islands,El Salvador,957,1561,1,4,-4,4,953,1565,192,67,0,1,192,68,40,100,-504
702,Sep 6 2011,Friendly in the United States,Colombia,Jamaica,1775,1658,2,0,10,-10,1785,1648,19,51,2,-1,21,50,20,0,117
703,Sep 6 2011,European Championship qual in Croatia,Croatia,Israel,1890,1669,3,1,8,-8,1898,1661,8,48,1,-1,9,47,40,100,321
704,Sep 6 2011,World Cup qualifier in Curaçao,Curaçao,Haiti,1092,1430,2,4,-12,12,1080,1442,176,100,0,1,176,101,40,100,-238
705,Sep 6 2011,Friendly in Czechia,Czechia,Ukraine,1732,1753,4,0,15,-15,1747,1738,29,34,2,-2,31,32,20,100,79
706,Sep 6 2011,European Championship qual in Denmark,Denmark,Norway,1750,1794,2,0,25,-25,1775,1769,17,30,7,-5,24,25,30,0,-44
707,Sep 6 2011,World Cup qualifier in the Dominican Republic,Dominican Republic,Suriname,1066,1271,1,1,6,-6,1072,1265,175,139,2,0,177,139,40,100,-105
708,Sep 6 2011,Friendly in Ecuador,Ecuador,Costa Rica,1726,1660,4,0,10,-10,1736,1650,32,50,1,-1,33,49,20,100,166
709,Sep 6 2011,European Championship qual in England,England,Wales,1944,1562,1,0,2,-2,1946,1560,6,70,0,-1,6,69,20,0,382
710,Sep 6 2011,European Championship qual in Estonia,Estonia,Northern Ireland,1485,1513,4,1,28,-28,1513,1485,73,104,9,-10,82,94,30,0,-28
711,Sep 6 2011,European Championship qual in Finland,Finland,Netherlands,1614,2113,0,2,-5,5,1609,2118,56,2,1,0,57,2,40,100,-399
712,Sep 6 2011,Friendly in France,Gabon,Niger,1555,1341,1,0,5,-5,1560,1336,68,131,1,-5,69,126,20,0,214
713,Sep 6 2011,World Cup qualifier in Guyana,Guyana,Bermuda,1339,1150,2,1,6,-6,1345,1144,113,171,6,-2,119,169,40,100,289
714,Sep 6 2011,Friendly in Honduras,Honduras,Paraguay,1650,1798,0,3,-15,15,1635,1813,56,15,-2,2,54,17,20,100,-48
715,Sep 6 2011,European Championship qual in Iceland,Iceland,Cyprus,1424,1515,1,0,19,-19,1443,1496,97,96,3,-7,100,89,30,0,-91
716,Sep 6 2011,World Cup qualifier in Indonesia,Indonesia,Bahrain,1323,1460,0,2,-27,27,1296,1487,135,90,-2,3,133,93,40,100,-37
717,Sep 6 2011,European Championship qual in Italy,Italy,Slovenia,1877,1649,1,0,5,-5,1882,1644,11,49,0,2,11,51,40,100,328
718,Sep 6 2011,World Cup qualifier in Jordan,Jordan,China,1545,1663,2,1,21,-21,1566,1642,61,57,6,-5,67,52,40,100,-18
719,Sep 6 2011,World Cup qualifier in Kuwait,Kuwait,South Korea,1603,1806,1,1,6,-6,1609,1800,54,18,3,0,57,18,40,100,-103
720,Sep 6 2011,European Championship qual in Latvia,Latvia,Greece,1509,1774,1,1,9,-9,1518,1765,75,30,5,-3,80,27,40,100,-165
721,Sep 6 2011,World Cup qualifier in Lebanon,Lebanon,United Arab Emirates,1166,1454,3,1,45,-45,1211,1409,144,118,9,-10,153,108,40,100,-188
722,Sep 6 2011,European Championship qual in Luxembourg,Luxembourg,Albania,1119,1527,2,1,34,-34,1153,1493,161,103,6,-12,167,91,40,100,-308
723,Sep 6 2011,European Championship qual in Macedonia,Macedonia,Andorra,1535,1000,1,0,1,-1,1536,999,76,188,0,0,76,188,20,0,535
724,Sep 6 2011,European Championship qual in Malta,Malta,Georgia,1215,1505,1,1,10,-10,1225,1495,145,93,3,-3,148,90,30,0,-290
725,Sep 6 2011,European Championship qual in Moldova,Moldova,Hungary,1432,1673,0,2,-18,18,1414,1691,109,37,-4,4,105,41,40,100,-141
726,Sep 6 2011,World Cup qualifier in Nicaragua,Nicaragua,Panama,1112,1648,1,2,-3,3,1109,1651,175,42,0,6,175,48,40,100,-436
727,Sep 6 2011,World Cup qualifier in North Korea,North Korea,Tajikistan,1494,1254,1,0,5,-5,1499,1249,86,145,2,-1,88,144,40,100,340
728,Sep 6 2011,Friendly in Poland,Poland,Germany,1689,2063,2,2,7,-7,1696,2056,39,3,0,0,39,3,20,100,-274
729,Sep 6 2011,World Cup qualifier in Puerto Rico,Puerto Rico,Canada,1009,1615,0,3,-4,4,1005,1619,188,55,-1,1,187,56,40,100,-506
730,Sep 6 2011,World Cup qualifier in Qatar,Qatar,Iran,1485,1741,1,1,8,-8,1493,1733,91,36,0,-2,91,34,40,100,-156
731,Sep 6 2011,European Championship qual in Romania,Romania,France,1710,1851,0,0,2,-2,1712,1849,38,13,0,0,38,13,30,100,-41
732,Sep 6 2011,European Championship qual in Russia,Russia,Ireland,1807,1788,0,0,-7,7,1800,1795,19,19,-1,1,18,20,40,100,119
733,Sep 6 2011,European Championship qual in San Marino,San Marino,Sweden,897,1837,0,5,-1,1,896,1838,199,13,0,1,199,14,40,100,-840
734,Sep 6 2011,World Cup qualifier in Saudi Arabia,Saudi Arabia,Australia,1575,1820,1,3,-18,18,1557,1838,77,12,-6,2,71,14,40,100,-145
735,Sep 6 2011,European Championship qual in Scotland,Scotland,Lithuania,1687,1535,1,0,8,-8,1695,1527,40,80,0,-2,40,78,40,100,252
736,Sep 6 2011,European Championship qual in Serbia,Serbia,Faroe Islands,1762,1224,3,1,1,-1,1763,1223,30,149,-1,0,29,149,20,0,538
737,Sep 6 2011,World Cup qualifier in Singapore,Singapore,Iraq,1339,1518,0,2,-23,23,1316,1541,135,67,-5,7,130,74,40,100,-79
738,Sep 6 2011,European Championship qual in Slovakia,Slovakia,Armenia,1656,1443,0,4,-64,64,1592,1507,69,70,-9,15,60,85,40,100,313
739,Sep 6 2011,European Championship qual in Spain,Spain,Liechtenstein,2125,1242,6,0,0,0,2125,1242,1,147,0,0,1,147,20,0,883
740,Sep 6 2011,World Cup qualifier in Saint Lucia,Saint Lucia,Saint Kitts and Nevis,1045,1173,2,4,-28,28,1017,1201,186,150,-2,5,184,155,40,100,-28
741,Sep 6 2011,European Championship qual in Switzerland,Switzerland,Bulgaria,1765,1683,3,1,16,-16,1781,1667,18,49,4,-4,22,45,40,100,182
742,Sep 6 2011,World Cup qualifier in Thailand,Thailand,Oman,1386,1554,3,0,42,-42,1428,1512,93,95,9,-12,102,83,40,100,-68
743,Sep 6 2011,World Cup qualifier in the US Virgin Islands,US Virgin Islands,Antigua and Barbuda,736,1276,1,8,-7,7,729,1283,211,135,0,1,211,136,40,100,-440
744,Sep 6 2011,World Cup qualifier in Uzbekistan,Uzbekistan,Japan,1579,1838,1,1,9,-9,1588,1829,60,18,2,-2,62,16,30,0,-259
745,Sep 6 2011,Friendly in Venezuela,Venezuela,Guinea,1711,1514,2,1,3,-3,1714,1511,35,85,1,-1,36,84,20,100,297
746,Sep 7 2011,Friendly in Equatorial Guinea,Equatorial Guinea,Central African Republic,1204,1259,3,0,15,-15,1219,1244,146,148,4,-3,150,145,20,100,45
747,Sep 7 2011,Pacific Games in New Caledonia,New Caledonia,Tahiti,1263,1159,3,1,14,-14,1277,1145,136,170,2,-2,138,168,40,100,204
748,Sep 7 2011,Pacific Games in New Caledonia,Solomon Islands,Fiji,1285,1351,2,1,24,-24,1309,1327,129,138,3,-10,132,128,40,0,-66
749,Sep 9 2011,Pacific Games in New Caledonia,New Caledonia,Solomon Islands,1277,1309,2,0,24,-24,1301,1285,126,140,6,-4,132,136,40,100,68
750,Sep 9 2011,Pacific Games in New Caledonia,Tahiti,Fiji,1145,1327,2,1,30,-30,1175,1297,156,138,6,-5,162,133,40,0,-182
751,Sep 11 2011,Friendly in St Vincent & Grenadines,St Vincent & Grenadines,Dominica,1181,1042,1,0,4,-4,1185,1038,158,182,1,0,159,182,20,100,239
752,Sep 14 2011,Friendly tournament in Argentina,Argentina,Brazil,1928,2037,0,0,0,0,1928,2037,7,4,0,0,7,4,20,100,-9
753,Sep 18 2011,World Cup qualifier in St Vincent & Grenadines,St Vincent & Grenadines,Grenada,1185,1176,2,1,14,-14,1199,1162,153,169,3,-4,156,165,40,100,109
754,Sep 23 2011,Friendly in Suriname,Suriname,Curaçao,1265,1080,2,0,5,-5,1270,1075,140,176,0,0,140,176,20,100,285
755,Sep 25 2011,Friendly in Suriname,Suriname,Curaçao,1270,1075,2,2,-7,7,1263,1082,140,176,0,0,140,176,20,100,295
756,Sep 28 2011,Friendly tournament in Brazil,Brazil,Argentina,2037,1928,2,0,10,-10,2047,1918,4,7,0,0,4,7,20,0,109
757,Sep 30 2011,Friendly in Antigua and Barbuda,Antigua and Barbuda,Martinique,1283,1339,1,0,9,-9,1292,1330,135,129,1,-3,136,126,20,100,44
758,Sep 30 2011,Friendly tournament in Taiwan,Hong Kong,Philippines,1183,1008,3,3,-7,7,1176,1015,160,184,0,1,160,185,20,100,275
759,Sep 30 2011,Friendly tournament in Taiwan,Taiwan,Macao,916,673,3,0,6,-6,922,667,196,220,0,0,196,220,30,100,343
760,Oct 1 2011,Friendly in Ethiopia,Ethiopia,Sudan,1313,1410,1,2,-10,10,1303,1420,132,103,-1,2,131,105,20,100,3
761,Oct 2 2011,Friendly in Antigua and Barbuda,Antigua and Barbuda,Martinique,1292,1330,1,2,-12,12,1280,1342,140,114,-2,6,138,120,20,100,62
762,Oct 2 2011,Friendly tournament in Taiwan,Hong Kong,Macao,1176,667,5,1,3,-3,1179,664,160,220,0,0,160,220,30,0,509
763,Oct 2 2011,Friendly tournament in Taiwan,Taiwan,Philippines,922,1015,0,0,0,0,922,1015,196,185,0,0,196,185,20,100,7
764,Oct 4 2011,Friendly in Ethiopia,Ethiopia,Malawi,1303,1422,0,0,1,-1,1304,1421,131,104,0,0,131,104,20,100,-19
765,Oct 4 2011,Friendly tournament in Taiwan,Philippines,Macao,1015,664,2,0,5,-5,1020,659,183,220,1,0,184,220,30,0,351
766,Oct 4 2011,Friendly tournament in Taiwan,Taiwan,Hong Kong,922,1179,0,6,-18,18,904,1197,198,156,-1,2,197,158,30,100,-157
767,Oct 5 2011,Friendly in Iran,Iran,Palestine,1733,1170,7,0,1,-1,1734,1169,34,162,0,0,34,162,20,100,663
768,Oct 6 2011,Friendly in China,China,United Arab Emirates,1642,1409,2,1,3,-3,1645,1406,50,110,1,-1,51,109,20,100,333
769,Oct 6 2011,Friendly in Thailand,Thailand,Jordan,1428,1566,0,0,1,-1,1429,1565,102,67,0,0,102,67,20,100,-38
770,Oct 7 2011,European Championship qual in Andorra,Andorra,Ireland,999,1795,0,2,-1,1,998,1796,188,18,0,1,188,19,20,100,-696
771,Oct 7 2011,World Cup qualifier in Argentina,Argentina,Chile,1918,1891,4,1,23,-23,1941,1868,5,10,1,0,6,10,40,100,127
772,Oct 7 2011,European Championship qual in Armenia,Armenia,Macedonia,1507,1536,4,1,28,-28,1535,1508,67,92,9,-8,76,84,30,0,-29
773,Oct 7 2011,Friendly in Australia,Australia,Malaysia,1838,1214,5,0,1,-1,1839,1213,16,152,-1,0,15,152,20,0,624
774,Oct 7 2011,European Championship qual in Azerbaijan,Azerbaijan,Austria,1426,1557,1,4,-32,32,1394,1589,117,53,-7,9,110,62,40,100,-31
775,Oct 7 2011,World Cup qualifier in Barbados,Barbados,Guyana,1213,1345,0,2,-27,27,1186,1372,167,116,-7,1,160,117,40,100,-32
776,Oct 7 2011,European Championship qual in Belgium,Belgium,Kazakhstan,1667,1338,4,1,5,-5,1672,1333,45,126,0,-1,45,125,20,0,329
777,Oct 7 2011,World Cup qualifier in Belize,Belize,Grenada,1132,1162,1,4,-42,42,1090,1204,178,143,-3,11,175,154,40,100,70
778,Oct 7 2011,World Cup qualifier in Bermuda,Bermuda,Trinidad and Tobago,1144,1516,2,1,33,-33,1177,1483,155,105,7,-12,162,93,40,100,-272
779,Oct 7 2011,European Championship qual in Bosnia and Herzegovina,Bosnia and Herzegovina,Luxembourg,1686,1153,5,0,2,-2,1688,1151,44,169,-1,-1,43,168,20,0,533
780,Oct 7 2011,World Cup qualifier in the Cayman Islands,Cayman Islands,Suriname,953,1263,0,1,-9,9,944,1272,192,140,0,0,192,140,40,100,-210
781,Oct 7 2011,Friendly in Costa Rica,Costa Rica,Brazil,1650,2047,0,1,-3,3,1647,2050,53,4,-2,0,51,4,20,100,-297
782,Oct 7 2011,World Cup qualifier in Curaçao,Curaçao,Antigua and Barbuda,1082,1280,0,1,-15,15,1067,1295,182,132,-3,3,179,135,40,100,-98
783,Oct 7 2011,European Championship qual in Cyprus,Cyprus,Denmark,1496,1775,1,4,-18,18,1478,1793,99,18,-5,3,94,21,40,100,-179
784,Oct 7 2011,European Championship qual in Czechia,Czechia,Spain,1747,2125,0,2,-10,10,1737,2135,35,1,-2,0,33,1,40,100,-278
785,Oct 7 2011,World Cup qualifier in Dominica,Dominica,Panama,1038,1651,0,5,-4,4,1034,1655,182,48,0,0,182,48,40,100,-513
786,Oct 7 2011,World Cup qualifier in the Dominican Republic,Dominican Republic,El Salvador,1072,1565,1,2,-4,4,1068,1569,179,69,-1,-1,178,68,40,100,-393
787,Oct 7 2011,African Nations Cup qualifier in the Dem Rep of the Congo,DR Congo,Cameroon,1409,1639,2,3,-13,13,1396,1652,110,45,-1,4,109,49,40,100,-130
788,Oct 7 2011,World Cup qualifier in Ecuador,Ecuador,Venezuela,1736,1714,2,0,20,-20,1756,1694,27,44,3,-4,30,40,40,100,122
789,Oct 7 2011,European Championship qual in Finland,Finland,Sweden,1609,1838,1,2,-13,13,1596,1851,65,14,-4,0,61,14,40,100,-129
790,Oct 7 2011,European Championship qual in France,France,Albania,1849,1493,3,0,5,-5,1854,1488,13,89,0,1,13,90,40,100,456
791,Oct 7 2011,Friendly in France,Gabon,Equatorial Guinea,1560,1219,2,0,4,-4,1564,1215,73,152,-2,-1,71,151,20,0,341
792,Oct 7 2011,European Championship qual in Greece,Greece,Croatia,1765,1898,2,0,33,-33,1798,1865,9,15,9,-3,18,12,40,100,-33
793,Oct 7 2011,Friendly in Malaysia,Indonesia,Saudi Arabia,1296,1557,0,0,6,-6,1302,1551,130,73,2,-1,132,72,20,0,-261
794,Oct 7 2011,Friendly in Japan,Japan,Vietnam,1829,1274,1,0,0,0,1829,1274,16,139,0,0,16,139,20,100,655
795,Oct 7 2011,European Championship qual in Latvia,Latvia,Malta,1518,1225,2,0,6,-6,1524,1219,80,150,0,-1,80,149,40,100,393
796,Oct 7 2011,European Championship qual in Montenegro,Montenegro,England,1683,1946,2,2,9,-9,1692,1937,39,8,2,-1,41,7,40,100,-163
797,Oct 7 2011,European Championship qual in the Netherlands,Netherlands,Moldova,2118,1414,1,0,0,0,2118,1414,2,104,0,1,2,105,20,0,704
798,Oct 7 2011,European Championship qual in Northern Ireland,Northern Ireland,Estonia,1485,1513,1,2,-24,24,1461,1537,102,68,-4,7,98,75,40,100,72
799,Oct 7 2011,World Cup qualifier in Peru,Peru,Paraguay,1767,1813,2,0,25,-25,1792,1788,18,29,4,-6,22,23,30,0,-46
800,Oct 7 2011,European Championship qual in Portugal,Portugal,Iceland,1912,1443,5,3,2,-2,1914,1441,8,102,0,-1,8,101,20,0,469
801,Oct 7 2011,World Cup qualifier in Puerto Rico,Puerto Rico,Saint Kitts and Nevis,1005,1201,1,1,5,-5,1010,1196,187,159,0,-2,187,157,20,0,-196
802,Oct 7 2011,European Championship qual in Romania,Romania,Belarus,1712,1592,2,2,-11,11,1701,1603,36,58,1,1,37,59,40,100,220
803,Oct 7 2011,European Championship qual in Serbia,Serbia,Italy,1763,1882,1,1,1,-1,1764,1881,25,7,2,2,27,9,20,100,-19
804,Oct 7 2011,Friendly in Singapore,Singapore,Philippines,1316,1020,2,0,3,-3,1319,1017,129,184,0,0,129,184,20,100,396
805,Oct 7 2011,European Championship qual in Slovakia,Slovakia,Russia,1592,1800,0,1,-14,14,1578,1814,72,16,-6,1,66,17,40,100,-108
806,Oct 7 2011,Friendly in South Korea,South Korea,Poland,1800,1696,2,2,-5,5,1795,1701,22,35,-2,2,20,37,20,100,204
807,Oct 7 2011,World Cup qualifier in Saint Lucia,Saint Lucia,Canada,1017,1619,0,7,-5,5,1012,1624,185,56,0,0,185,56,40,100,-502
808,Oct 7 2011,World Cup qualifier in St Vincent & Grenadines,St Vincent & Grenadines,Guatemala,1199,1467,0,3,-19,19,1180,1486,166,89,-5,3,161,92,40,100,-168
809,Oct 7 2011,European Championship qual in Turkey,Turkey,Germany,1780,2056,1,3,-16,16,1764,2072,31,3,-4,0,27,3,40,100,-176
810,Oct 7 2011,Friendly in Ukraine,Ukraine,Bulgaria,1738,1667,3,0,10,-10,1748,1657,30,49,1,-2,31,47,20,100,171
811,Oct 7 2011,World Cup qualifier in Uruguay,Uruguay,Bolivia,1964,1538,4,2,3,-3,1967,1535,5,77,0,-1,5,76,40,100,526
812,Oct 7 2011,World Cup qualifier in the US Virgin Islands,US Virgin Islands,Haiti,729,1442,0,7,-3,3,726,1445,213,99,-1,1,212,100,40,100,-613
813,Oct 7 2011,European Championship qual in Wales,Wales,Switzerland,1560,1781,2,0,40,-40,1600,1741,51,42,9,-10,60,32,40,100,-121
814,Oct 8 2011,African Nations Cup qualifier in Cape Verde,Cape Verde,Zimbabwe,1382,1385,2,1,15,-15,1397,1370,104,122,5,-5,109,117,30,0,-3
815,Oct 8 2011,African Nations Cup qualifier in Chad,Chad,Malawi,1198,1421,2,2,7,-7,1205,1414,151,103,2,0,153,103,40,100,-123
816,Oct 8 2011,African Nations Cup qualifier in Egypt,Egypt,Niger,1720,1336,3,0,4,-4,1724,1332,35,128,0,-2,35,126,40,100,484
817,Oct 8 2011,African Nations Cup qualifier in Ethiopia,Ethiopia,Madagascar,1304,1216,4,2,15,-15,1319,1201,127,160,2,-5,129,155,40,100,188
818,Oct 8 2011,African Nations Cup qualifier in The Gambia,Gambia,Burkina Faso,1374,1522,1,1,3,-3,1377,1519,112,83,2,-1,114,82,40,100,-48
819,Oct 8 2011,African Nations Cup qualifier in Guinea-Bissau,Guinea-Bissau,Angola,1260,1463,0,2,-21,21,1239,1484,151,90,-5,3,146,93,40,100,-103
820,Oct 8 2011,African Nations Cup qualifier in Liberia,Liberia,Mali,1246,1507,2,2,9,-9,1255,1498,138,89,3,-2,141,87,40,100,-161
821,Oct 8 2011,European Championship qual in Liechtenstein,Liechtenstein,Scotland,1242,1695,0,1,-5,5,1237,1700,147,39,0,0,147,39,40,100,-353
822,Oct 8 2011,African Nations Cup qualifier in Mozambique,Mozambique,Comoros,1341,879,3,0,3,-3,1344,876,119,203,1,0,120,203,30,0,462
823,Oct 8 2011,African Nations Cup qualifier in Nigeria,Nigeria,Guinea,1677,1511,2,2,-13,13,1664,1524,46,77,-1,3,45,80,40,100,266
824,Oct 8 2011,African Nations Cup qualifier in South Africa,South Africa,Sierra Leone,1628,1327,0,0,-16,16,1612,1343,57,114,-1,7,56,121,40,100,401
825,Oct 8 2011,African Nations Cup qualifier in Sudan,Sudan,Ghana,1420,1760,0,2,-12,12,1408,1772,108,21,-2,4,106,25,40,100,-240
826,Oct 8 2011,African Nations Cup qualifier in Swaziland,Swaziland,Congo,1139,1341,0,1,-14,14,1125,1355,173,117,-1,2,172,119,40,100,-102
827,Oct 8 2011,African Nations Cup qualifier in Tunisia,Tunisia,Togo,1582,1384,2,0,9,-9,1591,1375,60,117,2,-2,62,115,40,100,298
828,Oct 8 2011,African Nations Cup qualifier in Uganda,Uganda,Kenya,1542,1283,0,0,-16,16,1526,1299,85,130,-6,4,79,134,40,100,359
829,Oct 8 2011,Friendly in the United States,United States,Honduras,1714,1635,1,0,5,-5,1719,1630,36,54,0,0,36,54,20,100,179
830,Oct 8 2011,African Nations Cup qualifier in Zambia,Zambia,Libya,1535,1503,0,0,-7,7,1528,1510,78,82,-1,2,77,84,40,100,132
831,Oct 9 2011,African Nations Cup qualifier in Algeria,Algeria,Central African Republic,1463,1244,2,0,8,-8,1471,1236,95,150,1,-3,96,147,40,100,319
832,Oct 9 2011,African Nations Cup qualifier in Benin,Benin,Rwanda,1411,1329,0,1,-30,30,1381,1359,119,108,-7,10,112,118,40,100,182
833,Oct 9 2011,African Nations Cup qualifier in Ivory Coast,Ivory Coast,Burundi,1765,1243,2,1,1,-1,1766,1242,27,143,0,1,27,144,20,0,522
834,Oct 9 2011,African Nations Cup qualifier in Mauritius,Mauritius,Senegal,1028,1604,0,2,-4,4,1024,1608,183,58,0,0,183,58,40,100,-476
835,Oct 9 2011,African Nations Cup qualifier in Morocco,Morocco,Tanzania,1582,1340,3,1,7,-7,1589,1333,61,126,2,-1,63,125,40,100,342
836,Oct 11 2011,European Championship qual in Albania,Albania,Romania,1488,1701,1,1,6,-6,1494,1695,86,45,2,-4,88,41,40,100,-113
837,Oct 11 2011,World Cup qualifier in Antigua and Barbuda,Antigua and Barbuda,US Virgin Islands,1295,726,10,0,2,-2,1297,724,132,214,2,-1,134,213,20,0,569
838,Oct 11 2011,World Cup qualifier in Australia,Australia,Oman,1839,1512,3,0,6,-6,1845,1506,13,85,1,-1,14,84,40,100,427
839,Oct 11 2011,World Cup qualifier in Bermuda,Bermuda,Guyana,1177,1372,1,1,5,-5,1182,1367,158,118,2,-1,160,117,20,0,-195
840,Oct 11 2011,World Cup qualifier in Bolivia,Bolivia,Colombia,1535,1785,1,2,-12,12,1523,1797,83,18,-4,3,79,21,40,100,-150
841,Oct 11 2011,European Championship qual in Bulgaria,Bulgaria,Wales,1657,1600,0,1,-28,28,1629,1628,59,48,-6,6,53,54,40,100,157
842,Oct 11 2011,World Cup qualifier in Canada,Canada,Puerto Rico,1624,1010,0,0,-19,19,1605,1029,65,179,-5,4,60,183,40,0,614
843,Oct 11 2011,World Cup qualifier in Chile,Chile,Peru,1868,1792,4,2,16,-16,1884,1776,8,26,1,-2,9,24,40,100,176
844,Oct 11 2011,World Cup qualifier in China,China,Iraq,1645,1541,0,1,-31,31,1614,1572,58,65,-3,4,55,69,40,100,204
845,Oct 11 2011,European Championship qual in Croatia,Croatia,Latvia,1865,1524,2,0,4,-4,1869,1520,12,80,0,0,12,80,20,0,341
846,Oct 11 2011,European Championship qual in Denmark,Denmark,Portugal,1793,1914,2,1,21,-21,1814,1893,13,8,4,0,17,8,40,100,-21
847,Oct 11 2011,World Cup qualifier in El Salvador,El Salvador,Cayman Islands,1569,944,4,0,1,-1,1570,943,72,192,-2,0,70,192,20,0,625
848,Oct 11 2011,Friendly in Equatorial Guinea,Equatorial Guinea,Cameroon,1215,1652,1,1,7,-7,1222,1645,148,51,1,-1,149,50,20,100,-337
849,Oct 11 2011,Friendly in Estonia,Estonia,Ukraine,1537,1748,0,2,-10,10,1527,1758,78,33,-2,-1,76,32,20,100,-111
850,Oct 11 2011,European Championship qual in France,France,Bosnia and Herzegovina,1854,1688,1,1,-13,13,1841,1701,17,35,-2,4,15,39,40,100,266
851,Oct 11 2011,European Championship qual in Georgia,Georgia,Greece,1495,1798,1,2,-9,9,1486,1807,94,20,-3,-1,91,19,40,100,-203
852,Oct 11 2011,European Championship qual in Germany,Germany,Belgium,2072,1672,3,1,3,-3,2075,1669,3,44,0,0,3,44,20,0,400
853,Oct 11 2011,Friendly in England,Ghana,Nigeria,1772,1664,0,0,-3,3,1769,1667,27,47,-1,-1,26,46,20,0,108
854,Oct 11 2011,World Cup qualifier in Guatemala,Guatemala,Belize,1486,1090,3,1,3,-3,1489,1087,88,177,2,-1,90,176,20,0,396
855,Oct 11 2011,World Cup qualifier in Haiti,Haiti,Curaçao,1445,1067,2,2,-18,18,1427,1085,104,175,-2,2,102,177,40,100,478
856,Oct 11 2011,Friendly in Honduras,Honduras,Jamaica,1630,1648,2,1,8,-8,1638,1640,50,52,2,-1,52,51,20,100,82
857,Oct 11 2011,European Championship qual in Hungary,Hungary,Finland,1691,1596,0,0,-10,10,1681,1606,42,57,0,2,42,59,40,100,195
858,Oct 11 2011,World Cup qualifier in Indonesia,Indonesia,Qatar,1302,1493,2,3,-15,15,1287,1508,142,77,-5,6,137,83,40,100,-91
859,Oct 11 2011,World Cup qualifier in Iran,Iran,Bahrain,1734,1487,6,0,10,-10,1744,1477,32,97,1,-3,33,94,40,100,347
860,Oct 11 2011,European Championship qual in Ireland,Ireland,Armenia,1796,1535,2,1,4,-4,1800,1531,21,73,-1,1,20,74,20,0,261
861,Oct 11 2011,European Championship qual in Italy,Italy,Northern Ireland,1881,1461,3,0,3,-3,1884,1458,9,98,0,0,9,98,20,0,420
862,Oct 11 2011,World Cup qualifier in Japan,Japan,Tajikistan,1829,1249,8,0,2,-2,1831,1247,16,141,0,1,16,142,20,0,580
863,Oct 11 2011,European Championship qual in Kazakhstan,Kazakhstan,Austria,1333,1589,0,0,8,-8,1341,1581,125,69,0,-3,125,66,40,100,-156
864,Oct 11 2011,World Cup qualifier in Lebanon,Lebanon,Kuwait,1211,1609,2,2,14,-14,1225,1595,142,65,5,-4,147,61,40,100,-298
865,Oct 11 2011,European Championship qual in Lithuania,Lithuania,Czechia,1527,1737,1,4,-24,24,1503,1761,94,27,-8,3,86,30,40,100,-110
866,Oct 11 2011,European Championship qual in Macedonia,Macedonia,Slovakia,1508,1578,1,1,-2,2,1506,1580,83,68,1,-1,84,67,40,100,30
867,Oct 11 2011,European Championship qual in Malta,Malta,Israel,1219,1661,0,2,-7,7,1212,1668,155,44,-3,1,152,45,40,100,-342
868,Oct 11 2011,Friendly in Mexico,Mexico,Brazil,1866,2050,1,2,-8,8,1858,2058,15,4,-2,0,13,4,20,100,-84
869,Oct 11 2011,European Championship qual in Moldova,Moldova,San Marino,1414,896,4,0,2,-2,1416,894,103,201,0,-1,103,200,20,0,518
870,Oct 11 2011,World Cup qualifier in North Korea,North Korea,Uzbekistan,1499,1588,0,1,-21,21,1478,1609,100,49,-7,8,93,57,40,100,11
871,Oct 11 2011,European Championship qual in Norway,Norway,Cyprus,1769,1478,3,1,6,-6,1775,1472,24,95,1,0,25,95,40,100,391
872,Oct 11 2011,World Cup qualifier in Panama,Panama,Nicaragua,1655,1109,5,1,2,-2,1657,1107,48,176,0,-1,48,175,20,0,546
873,Oct 11 2011,World Cup qualifier in Paraguay,Paraguay,Uruguay,1788,1967,1,1,4,-4,1792,1963,23,5,0,0,23,5,40,100,-79
874,Oct 11 2011,Friendly in the Philippines,Philippines,Nepal,1017,974,4,0,11,-11,1028,963,184,192,0,-1,184,191,20,100,143
875,Oct 11 2011,Friendly in Germany,Poland,Belarus,1701,1603,2,0,11,-11,1712,1592,37,65,0,-3,37,62,20,0,98
876,Oct 11 2011,European Championship qual in Russia,Russia,Andorra,1814,998,6,0,0,0,1814,998,17,188,0,0,17,188,20,0,816
877,Oct 11 2011,World Cup qualifier in Singapore,Singapore,Jordan,1319,1565,0,3,-21,21,1298,1586,137,60,-4,5,133,65,40,100,-146
878,Oct 11 2011,European Championship qual in Slovenia,Slovenia,Serbia,1644,1764,1,0,21,-21,1665,1743,41,40,6,-6,47,34,40,100,-20
879,Oct 11 2011,World Cup qualifier in South Korea,South Korea,United Arab Emirates,1795,1406,2,1,2,-2,1797,1404,22,106,-1,0,21,106,20,0,389
880,Oct 11 2011,European Championship qual in Spain,Spain,Scotland,2135,1700,3,1,3,-3,2138,1697,1,41,0,-1,1,40,30,0,435
881,Oct 11 2011,World Cup qualifier in Saint Kitts and Nevis,Saint Kitts and Nevis,Saint Lucia,1196,1012,1,1,-13,13,1183,1025,161,185,-2,0,159,185,40,100,284
882,Oct 11 2011,World Cup qualifier in Suriname,Suriname,Dominican Republic,1272,1068,1,3,-51,51,1221,1119,160,168,-10,5,150,173,40,100,304
883,Oct 11 2011,European Championship qual in Sweden,Sweden,Netherlands,1851,2118,3,2,29,-29,1880,2089,8,2,3,0,11,2,40,100,-167
884,Oct 11 2011,European Championship qual in Switzerland,Switzerland,Montenegro,1741,1692,2,0,18,-18,1759,1674,30,45,1,-2,31,43,40,100,149
885,Oct 11 2011,World Cup qualifier in Thailand,Thailand,Saudi Arabia,1429,1551,0,0,1,-1,1430,1550,100,74,1,-1,101,73,20,100,-22
886,Oct 11 2011,World Cup qualifier in Trinidad and Tobago,Trinidad and Tobago,Barbados,1483,1186,4,0,7,-7,1490,1179,84,164,5,-2,89,162,40,100,397
887,Oct 11 2011,European Championship qual in Turkey,Turkey,Azerbaijan,1764,1394,1,0,3,-3,1767,1391,28,110,0,0,28,110,30,0,370
888,Oct 11 2011,Friendly in the United States,United States,Ecuador,1719,1756,0,1,-12,12,1707,1768,40,24,-2,3,38,27,20,100,63
889,Oct 11 2011,World Cup qualifier in Venezuela,Venezuela,Argentina,1694,1941,1,0,28,-28,1722,1913,32,8,4,-1,36,7,40,100,-147
890,Oct 15 2011,World Cup qualifier in Grenada,Grenada,St Vincent & Grenadines,1204,1180,1,1,-7,7,1197,1187,156,157,-1,2,155,159,40,100,124
891,Oct 31 2011,Friendly in Namibia,Namibia,Lesotho,1293,1162,0,0,-6,6,1287,1168,136,163,0,2,136,165,20,100,231
892,Nov 1 2011,Friendly in Djibouti,Djibouti,Somalia,793,911,1,0,11,-11,804,900,207,198,0,-1,207,197,20,100,-18
893,Nov 4 2011,Friendly in Kuwait,Kuwait,Bahrain,1595,1477,0,1,-16,16,1579,1493,73,84,-6,5,67,89,20,100,218
894,Nov 4 2011,Friendly in Qatar,Qatar,Oman,1508,1506,0,0,-3,3,1505,1509,87,82,-2,1,85,83,20,100,102
895,Nov 5 2011,Friendly in Antigua and Barbuda,Antigua and Barbuda,Guadeloupe,1297,1466,0,0,2,-2,1299,1464,130,97,2,0,132,97,20,100,-69
896,Nov 6 2011,Friendly in South Africa,DR Congo,Lesotho,1396,1168,3,0,7,-7,1403,1161,105,169,2,-2,107,167,20,0,228
897,Nov 6 2011,Friendly in Qatar,Iraq,Lebanon,1572,1225,1,0,2,-2,1574,1223,67,147,1,0,68,147,20,0,347
898,Nov 8 2011,Friendly in Qatar,Lebanon,Thailand,1223,1430,3,1,23,-23,1246,1407,139,109,4,-4,143,105,20,0,-207
899,Nov 10 2011,Friendly in Gabon,Gabon,Brazil,1564,2058,0,2,-3,3,1561,2061,72,4,0,0,72,4,20,100,-394
900,Nov 11 2011,Friendly in Albania,Albania,Azerbaijan,1494,1391,0,1,-15,15,1479,1406,96,98,-4,6,92,104,20,100,203
901,Nov 11 2011,World Cup qualifier in Antigua and Barbuda,Antigua and Barbuda,Haiti,1299,1427,1,0,22,-22,1321,1405,128,109,2,-4,130,105,40,100,-28
902,Nov 11 2011,World Cup qualifier in Argentina,Argentina,Bolivia,1913,1523,1,1,-18,18,1895,1541,11,71,-2,4,9,75,40,100,490
903,Nov 11 2011,World Cup qualifier in Bahrain,Bahrain,Iran,1493,1744,1,1,8,-8,1501,1736,85,31,2,1,87,32,40,100,-151
904,Nov 11 2011,Friendly in Belgium,Belgium,Romania,1669,1695,2,1,8,-8,1677,1687,42,41,1,0,43,41,20,100,74
905,Nov 11 2011,World Cup qualifier in Belize,Belize,St Vincent & Grenadines,1087,1187,1,1,0,0,1087,1187,178,159,-1,0,177,159,20,100,0
906,Nov 11 2011,World Cup qualifier in Bermuda,Bermuda,Barbados,1182,1179,2,1,14,-14,1196,1165,149,170,6,-4,155,166,40,100,103
907,Nov 11 2011,European Championship qual in Bosnia and Herzegovina,Bosnia and Herzegovina,Portugal,1701,1893,0,0,5,-5,1706,1888,35,12,2,-2,37,10,20,0,-192
908,Nov 11 2011,Friendly in France,Burkina Faso,Mali,1519,1498,1,1,-1,1,1518,1499,79,89,1,-1,80,88,20,0,21
909,Nov 11 2011,Friendly tournament in Morocco,Cameroon,Sudan,1645,1408,3,1,9,-9,1654,1399,48,110,1,-3,49,107,30,0,237
910,Nov 11 2011,World Cup qualifier in Chad,Chad,Tanzania,1205,1333,1,2,-18,18,1187,1351,165,116,-6,5,159,121,40,100,-28
911,Nov 11 2011,World Cup qualifier in Colombia,Colombia,Venezuela,1797,1722,1,1,-9,9,1788,1731,25,34,-2,1,23,35,40,100,175
912,Nov 11 2011,World Cup qualifier in the Comoros,Comoros,Mozambique,876,1344,0,1,-4,4,872,1348,203,123,0,-1,203,122,40,100,-368
913,Nov 11 2011,Friendly in Cyprus,Cyprus,Scotland,1472,1697,1,2,-7,7,1465,1704,97,36,-1,2,96,38,20,100,-125
914,Nov 11 2011,European Championship qual in Czechia,Czechia,Montenegro,1761,1674,2,0,15,-15,1776,1659,18,53,6,-5,24,48,40,100,187
915,Nov 11 2011,Friendly in Denmark,Denmark,Sweden,1814,1880,2,0,14,-14,1828,1866,15,11,1,0,16,11,20,100,34
916,Nov 11 2011,World Cup qualifier in Djibouti,Djibouti,Namibia,804,1287,0,4,-7,7,797,1294,207,134,0,1,207,135,40,100,-383
917,Nov 11 2011,World Cup qualifier in the Dominican Republic,Dominican Republic,Cayman Islands,1119,943,4,0,13,-13,1132,930,169,194,2,-1,171,193,40,100,276
918,Nov 11 2011,World Cup qualifier in Equatorial Guinea,Equatorial Guinea,Madagascar,1222,1201,2,0,20,-20,1242,1181,139,168,5,-7,144,161,40,100,121
919,Nov 11 2011,World Cup qualifier in Eritrea,Eritrea,Rwanda,1166,1359,1,1,5,-5,1171,1354,163,122,1,-2,164,120,20,0,-193
920,Nov 11 2011,European Championship qual in Estonia,Estonia,Ireland,1527,1800,0,4,-20,20,1507,1820,92,14,-8,3,84,17,40,100,-173
921,Nov 11 2011,Friendly in France,France,United States,1841,1707,1,0,4,-4,1845,1703,13,40,1,-1,14,39,20,100,234
922,Nov 11 2011,Friendly in Georgia,Georgia,Moldova,1486,1416,2,0,8,-8,1494,1408,88,104,2,-1,90,103,20,100,170
923,Nov 11 2011,Friendly in Greece,Greece,Russia,1807,1814,1,1,-3,3,1804,1817,25,19,-3,-1,22,18,20,100,93
924,Nov 11 2011,World Cup qualifier in Guatemala,Guatemala,Grenada,1489,1197,3,0,7,-7,1496,1190,87,159,2,-2,89,157,40,100,392
925,Nov 11 2011,World Cup qualifier in Guinea-Bissau,Guinea-Bissau,Togo,1239,1375,1,1,2,-2,1241,1373,145,119,0,-2,145,117,30,100,-36
926,Nov 11 2011,World Cup qualifier in Guyana,Guyana,Trinidad and Tobago,1367,1490,2,1,21,-21,1388,1469,107,100,5,-5,112,95,40,100,-23
927,Nov 11 2011,Friendly in Hungary,Hungary,Liechtenstein,1681,1237,5,0,2,-2,1683,1235,42,148,0,-1,42,147,20,100,544
928,Nov 11 2011,World Cup qualifier in Qatar,Iraq,China,1574,1614,1,0,22,-22,1596,1592,50,65,9,-5,59,60,40,0,-40
929,Nov 11 2011,World Cup qualifier in Jordan,Jordan,Singapore,1586,1298,2,0,6,-6,1592,1292,56,138,4,-2,60,136,40,100,388
930,Nov 11 2011,World Cup qualifier in Kuwait,Kuwait,Lebanon,1579,1246,0,1,-37,37,1542,1283,81,133,-7,5,74,138,40,100,433
931,Nov 11 2011,World Cup qualifier in Lesotho,Lesotho,Burundi,1161,1242,1,0,19,-19,1180,1223,157,152,5,-4,162,148,40,100,19
932,Nov 11 2011,Friendly in Mexico,Mexico,Serbia,1858,1743,2,0,7,-7,1865,1736,11,30,1,2,12,32,20,100,215
933,Nov 11 2011,Friendly tournament in Morocco,Morocco,Uganda,1589,1526,0,1,-22,22,1567,1548,75,69,-6,4,69,73,30,100,163
934,Nov 11 2011,Friendly in the Netherlands,Netherlands,Switzerland,2089,1759,0,0,-8,8,2081,1767,2,25,0,3,2,28,20,100,430
935,Nov 11 2011,World Cup qualifier in Nicaragua,Nicaragua,Dominica,1107,1034,1,0,11,-11,1118,1023,171,188,2,-3,173,185,40,100,173
936,Nov 11 2011,World Cup qualifier in Oman,Oman,Australia,1509,1845,1,0,32,-32,1541,1813,67,24,8,-5,75,19,40,100,-236
937,Nov 11 2011,Friendly in Panama,Panama,Costa Rica,1657,1647,2,0,10,-10,1667,1637,42,55,3,-3,45,52,20,100,110
938,Nov 11 2011,World Cup qualifier in Paraguay,Paraguay,Ecuador,1792,1768,2,1,13,-13,1805,1755,19,35,2,-4,21,31,40,100,124
939,Nov 11 2011,Friendly in Poland,Poland,Italy,1712,1884,0,2,-12,12,1700,1896,43,7,-3,1,40,8,20,100,-72
940,Nov 11 2011,World Cup qualifier in Puerto Rico,Puerto Rico,Saint Lucia,1029,1025,4,0,27,-27,1056,998,177,189,3,-2,180,187,40,100,104
941,Nov 11 2011,World Cup qualifier in Qatar,Qatar,Indonesia,1505,1287,4,0,10,-10,1515,1277,77,142,4,-3,81,139,40,100,318
942,Nov 11 2011,World Cup qualifier in São Tomé and Príncipe,São Tomé and Príncipe,Congo,1050,1355,0,5,-19,19,1031,1374,183,112,-1,4,182,116,40,100,-205
943,Nov 11 2011,World Cup qualifier in Saudi Arabia,Saudi Arabia,Thailand,1550,1407,3,0,14,-14,1564,1393,69,115,2,-5,71,110,40,100,243
944,Nov 11 2011,Friendly in France,Senegal,Guinea,1608,1524,4,1,13,-13,1621,1511,52,86,3,-4,55,82,20,0,84
945,Nov 11 2011,World Cup qualifier in the Seychelles,Seychelles,Kenya,1071,1299,0,3,-23,23,1048,1322,184,126,-3,3,181,129,40,100,-128
946,Nov 11 2011,World Cup qualifier in Saint Kitts and Nevis,Saint Kitts and Nevis,Canada,1183,1605,0,0,15,-15,1198,1590,146,68,7,-4,153,64,40,100,-322
947,Nov 11 2011,World Cup qualifier in Suriname,Suriname,El Salvador,1221,1570,1,3,-12,12,1209,1582,154,60,-2,5,152,65,40,100,-249
948,Nov 11 2011,World Cup qualifier in Swaziland,Swaziland,DR Congo,1125,1403,1,3,-16,16,1109,1419,178,95,-3,6,175,101,40,100,-178
949,Nov 11 2011,World Cup qualifier in Tajikistan,Tajikistan,Japan,1247,1831,0,4,-4,4,1243,1835,144,14,-1,1,143,15,40,100,-484
950,Nov 11 2011,European Championship qual in Turkey,Turkey,Croatia,1767,1869,0,3,-35,35,1732,1904,40,2,-6,5,34,7,40,100,-2
951,Nov 11 2011,World Cup qualifier in the United Arab Emirates,United Arab Emirates,South Korea,1404,1797,0,2,-9,9,1395,1806,112,19,-3,1,109,20,40,100,-293
952,Nov 11 2011,Friendly in Ukraine,Ukraine,Germany,1758,2075,3,3,6,-6,1764,2069,28,3,2,0,30,3,20,100,-217
953,Nov 11 2011,World Cup qualifier in Uruguay,Uruguay,Chile,1963,1884,4,0,20,-20,1983,1864,5,17,0,-4,5,13,40,100,179
954,Nov 11 2011,World Cup qualifier in the US Virgin Islands,US Virgin Islands,Curaçao,724,1085,0,3,-13,13,711,1098,213,175,0,1,213,176,40,100,-261
955,Nov 11 2011,World Cup qualifier in Uzbekistan,Uzbekistan,North Korea,1609,1478,1,0,8,-8,1617,1470,55,94,1,0,56,94,40,100,231
956,Nov 12 2011,Friendly in Algeria,Algeria,Tunisia,1471,1591,1,0,11,-11,1482,1580,91,69,1,-3,92,66,20,100,-20
957,Nov 12 2011,Friendly in England,England,Spain,1937,2138,1,0,13,-13,1950,2125,6,1,0,0,6,1,20,100,-101
958,Nov 12 2011,World Cup qualifier in Djibouti,Ethiopia,Somalia,1319,900,0,0,-17,17,1302,917,133,195,-1,1,132,196,40,0,419
959,Nov 12 2011,Friendly in Nigeria,Nigeria,Botswana,1667,1402,0,0,-8,8,1659,1410,49,100,-2,3,47,103,20,100,365
960,Nov 12 2011,Friendly tournament in South Africa,South Africa,Ivory Coast,1612,1766,1,1,2,-2,1614,1764,57,27,0,1,57,28,20,100,-54
961,Nov 12 2011,Friendly in Wales,Wales,Norway,1628,1775,4,1,20,-20,1648,1755,46,34,4,-4,50,30,20,100,-47
962,Nov 13 2011,Friendly in India,India,Malaysia,1195,1213,1,1,-2,2,1193,1215,156,150,0,0,156,150,20,100,82
963,Nov 13 2011,Friendly tournament in Morocco,Morocco,Cameroon,1567,1654,1,1,-1,1,1566,1655,71,49,-1,0,70,49,30,100,13
964,Nov 13 2011,Friendly tournament in Morocco,Sudan,Uganda,1399,1548,0,0,6,-6,1405,1542,105,73,1,0,106,73,30,0,-149
965,Nov 14 2011,World Cup qualifier in Bermuda,Bermuda,Barbados,1196,1165,2,1,13,-13,1209,1152,149,168,3,-1,152,167,40,100,131
966,Nov 14 2011,Friendly in Qatar,Brazil,Egypt,2061,1724,2,0,4,-4,2065,1720,4,36,0,0,4,36,20,0,337
967,Nov 14 2011,World Cup qualifier in the Cayman Islands,Cayman Islands,Dominican Republic,930,1132,1,1,6,-6,936,1126,191,173,1,-1,192,172,40,100,-102
968,Nov 14 2011,Friendly in Honduras,Honduras,Serbia,1638,1736,2,0,15,-15,1653,1721,48,38,2,-3,50,35,20,100,2
969,Nov 14 2011,World Cup qualifier in Puerto Rico,Puerto Rico,Saint Lucia,1056,998,3,0,20,-20,1076,978,176,191,2,-2,178,189,40,100,158
970,Nov 15 2011,Friendly in the United Arab Emirates,Belarus,Libya,1592,1510,1,1,-2,2,1590,1512,64,81,-2,1,62,82,20,0,82
971,Nov 15 2011,Friendly in France,Burkina Faso,Guinea,1518,1511,1,1,0,0,1518,1511,82,86,-1,-2,81,84,20,0,7
972,Nov 15 2011,World Cup qualifier in Burundi,Burundi,Lesotho,1223,1180,2,2,-8,8,1215,1188,152,158,-2,2,150,160,40,100,143
973,Nov 15 2011,World Cup qualifier in Canada,Canada,Saint Kitts and Nevis,1590,1198,4,0,4,-4,1594,1194,59,160,2,-3,61,157,20,0,392
974,Nov 15 2011,World Cup qualifier in Chile,Chile,Paraguay,1864,1805,2,0,17,-17,1881,1788,9,21,2,0,11,21,40,100,159
975,Nov 15 2011,World Cup qualifier in Colombia,Colombia,Argentina,1788,1895,1,2,-20,20,1768,1915,29,5,-3,2,26,7,40,100,-7
976,Nov 15 2011,World Cup qualifier in Congo,Congo,São Tomé and Príncipe,1374,1031,1,1,-17,17,1357,1048,122,180,-3,1,119,181,40,100,443
977,Nov 15 2011,Friendly in Costa Rica,Costa Rica,Spain,1637,2125,2,2,8,-8,1645,2117,49,1,2,0,51,1,20,100,-388
978,Nov 15 2011,European Championship qual in Croatia,Croatia,Turkey,1904,1732,0,0,-13,13,1891,1745,11,31,-2,1,9,32,40,100,272
979,Nov 15 2011,World Cup qualifier in Curaçao,Curaçao,US Virgin Islands,1098,711,6,1,5,-5,1103,706,176,213,0,0,176,213,40,100,487
980,Nov 15 2011,Friendly in Denmark,Denmark,Finland,1828,1606,2,1,3,-3,1831,1603,14,60,1,-1,15,59,20,100,322
981,Nov 15 2011,World Cup qualifier in the Dem Rep of the Congo,DR Congo,Swaziland,1419,1109,5,1,6,-6,1425,1103,101,177,0,-1,101,176,40,100,410
982,Nov 15 2011,World Cup qualifier in Ecuador,Ecuador,Peru,1755,1776,2,0,23,-23,1778,1753,16,38,7,-7,23,31,40,100,79
983,Nov 15 2011,World Cup qualifier in El Salvador,El Salvador,Suriname,1582,1209,4,0,5,-5,1587,1204,62,156,1,-2,63,154,40,100,473
984,Nov 15 2011,Friendly in England,England,Sweden,1950,1866,1,0,5,-5,1955,1861,6,15,0,-2,6,13,20,100,184
985,Nov 15 2011,Friendly in France,France,Belgium,1845,1677,0,0,-6,6,1839,1683,14,41,0,1,14,42,20,100,268
986,Nov 15 2011,Friendly in Germany,Germany,Netherlands,2069,2081,3,0,13,-13,2082,2068,1,4,1,-1,2,3,20,100,88
987,Nov 15 2011,Friendly in France,Ghana,Gabon,1769,1561,2,1,5,-5,1774,1556,22,70,2,1,24,71,20,0,208
988,Nov 15 2011,World Cup qualifier in Grenada,Grenada,Guatemala,1190,1496,1,4,-16,16,1174,1512,167,75,-5,7,162,82,40,100,-206
989,Nov 15 2011,World Cup qualifier in Haiti,Haiti,Antigua and Barbuda,1405,1321,2,1,10,-10,1415,1311,98,132,4,-1,102,131,40,100,184
990,Nov 15 2011,World Cup qualifier in Indonesia,Indonesia,Iran,1277,1736,1,4,-8,8,1269,1744,141,34,-1,-1,140,33,40,100,-359
991,Nov 15 2011,European Championship qual in Ireland,Ireland,Estonia,1820,1507,1,1,-17,17,1803,1524,19,72,-1,6,18,78,40,100,413
992,Nov 15 2011,Friendly in Italy,Italy,Uruguay,1896,1983,0,1,-10,10,1886,1993,12,5,-2,0,10,5,20,100,13
993,Nov 15 2011,World Cup qualifier in Jordan,Jordan,Iraq,1592,1596,1,3,-38,38,1554,1634,84,49,-12,5,72,54,40,100,96
994,Nov 15 2011,World Cup qualifier in Kenya,Kenya,Seychelles,1322,1048,4,0,8,-8,1330,1040,127,183,1,-1,128,182,40,100,374
995,Nov 15 2011,World Cup qualifier in Kuwait,Kuwait,United Arab Emirates,1542,1395,2,1,8,-8,1550,1387,73,113,0,-2,73,111,40,100,247
996,Nov 15 2011,World Cup qualifier in Lebanon,Lebanon,South Korea,1283,1806,2,1,37,-37,1320,1769,120,30,9,-5,129,25,40,100,-423
997,Nov 15 2011,Friendly in Luxembourg,Luxembourg,Switzerland,1151,1767,0,1,-1,1,1150,1768,166,25,1,1,167,26,20,0,-616
998,Nov 15 2011,Friendly in Macedonia,Macedonia,Albania,1506,1479,0,0,-4,4,1502,1483,93,95,-4,-1,89,94,20,100,127
999,Nov 15 2011,World Cup qualifier in Madagascar,Madagascar,Equatorial Guinea,1181,1242,2,1,18,-18,1199,1224,149,150,6,-3,155,147,30,0,-61
1000,Nov 15 2011,European Championship qual in Montenegro,Montenegro,Czechia,1659,1776,0,1,-19,19,1640,1795,57,16,-5,4,52,20,40,100,-17
1001,Nov 15 2011,World Cup qualifier in Mozambique,Mozambique,Comoros,1348,872,4,1,2,-2,1350,870,120,203,1,0,121,203,20,0,476
1002,Nov 15 2011,World Cup qualifier in Namibia,Namibia,Djibouti,1294,797,4,0,2,-2,1296,795,137,207,-1,0,136,207,20,0,497
1003,Nov 15 2011,Friendly in Niger,Niger,Botswana,1332,1410,1,1,-1,1,1331,1411,127,105,0,-1,127,104,20,100,22
1004,Nov 15 2011,Friendly in Nigeria,Nigeria,Zambia,1659,1528,2,0,6,-6,1665,1522,45,80,1,-1,46,79,20,100,231
1005,Nov 15 2011,World Cup qualifier in North Korea,North Korea,Japan,1470,1835,1,0,33,-33,1503,1802,80,23,7,-4,87,19,40,100,-265
1006,Nov 15 2011,World Cup qualifier in Panama,Panama,Dominica,1667,1023,3,0,1,-1,1668,1022,43,185,1,0,44,185,20,0,644
1007,Nov 15 2011,Friendly in Poland,Poland,Hungary,1700,1683,2,1,7,-7,1707,1676,36,44,2,-1,38,43,20,100,117
1008,Nov 15 2011,European Championship qual in Portugal,Portugal,Bosnia and Herzegovina,1888,1706,6,2,12,-12,1900,1694,6,45,2,-4,8,41,40,100,282
1009,Nov 15 2011,World Cup qualifier in Qatar,Qatar,Bahrain,1515,1501,0,0,-6,6,1509,1507,89,85,-4,1,85,86,40,100,114
1010,Nov 15 2011,Friendly in Austria,Romania,Greece,1687,1804,3,1,20,-20,1707,1784,35,22,3,0,38,22,20,0,-117
1011,Nov 15 2011,World Cup qualifier in Rwanda,Rwanda,Eritrea,1354,1171,3,1,10,-10,1364,1161,116,166,2,-1,118,165,40,100,283
1012,Nov 15 2011,World Cup qualifier in Saudi Arabia,Saudi Arabia,Oman,1564,1541,0,0,-7,7,1557,1548,69,73,1,1,70,74,40,100,123
1013,Nov 15 2011,World Cup qualifier in Singapore,Singapore,China,1292,1592,0,4,-18,18,1274,1610,140,56,-2,2,138,58,40,100,-200
1014,Nov 15 2011,Friendly in Slovenia,Slovenia,United States,1665,1703,2,3,-12,12,1653,1715,50,35,-2,2,48,37,20,100,62
1015,Nov 15 2011,World Cup qualifier in St Vincent & Grenadines,St Vincent & Grenadines,Belize,1187,1087,0,2,-46,46,1141,1133,181,165,-11,6,170,171,40,100,200
1016,Nov 15 2011,World Cup qualifier in Tanzania,Tanzania,Chad,1351,1187,0,1,-33,33,1318,1220,139,139,-9,10,130,149,40,100,264
1017,Nov 15 2011,World Cup qualifier in Thailand,Thailand,Australia,1393,1813,0,1,-5,5,1388,1818,110,13,0,3,110,16,40,100,-320
1018,Nov 15 2011,World Cup qualifier in Togo,Togo,Guinea-Bissau,1373,1241,1,0,8,-8,1381,1233,109,147,4,-1,113,146,40,100,232
1019,Nov 15 2011,World Cup qualifier in Trinidad and Tobago,Trinidad and Tobago,Guyana,1469,1388,2,0,16,-16,1485,1372,89,122,3,-5,92,117,40,100,181
1020,Nov 15 2011,Friendly in Ukraine,Ukraine,Austria,1764,1581,2,1,3,-3,1767,1578,28,67,0,-1,28,66,20,100,283
1021,Nov 15 2011,World Cup qualifier in Uzbekistan,Uzbekistan,Tajikistan,1617,1243,3,0,4,-4,1621,1239,56,143,0,0,56,143,20,0,374
1022,Nov 15 2011,World Cup qualifier in Venezuela,Venezuela,Bolivia,1731,1541,1,0,6,-6,1737,1535,34,77,0,-1,34,76,40,100,290
1023,Nov 15 2011,Friendly in Zimbabwe,Zimbabwe,South Africa,1370,1614,2,1,14,-14,1384,1600,106,63,6,-3,112,60,20,100,-144
1024,Nov 16 2011,World Cup qualifier in Ethiopia,Ethiopia,Somalia,1302,917,5,0,5,-5,1307,912,133,196,0,0,133,196,40,100,485
1025,Nov 16 2011,Friendly in India,India,Malaysia,1193,1215,3,2,8,-8,1201,1207,152,156,3,-3,155,153,20,100,78
1026,Nov 22 2011,WC & Oce Cup q in Samoa,Eastern Samoa,Tonga,335,690,2,1,35,-35,370,655,234,223,0,-3,234,220,40,0,-355
1027,Nov 22 2011,Friendly in the Maldives,Maldives,Seychelles,1116,1040,3,0,9,-9,1125,1031,173,182,1,0,174,182,20,100,176
1028,Nov 22 2011,WC & Oce Cup q in Samoa,Samoa,Cook Islands,684,729,3,2,17,-17,701,712,209,213,5,-1,214,212,30,0,-45
1029,Nov 24 2011,WC & Oce Cup q in Samoa,Cook Islands,Eastern Samoa,712,370,1,1,-15,15,697,385,218,234,-3,0,215,234,40,0,342
1030,Nov 24 2011,Friendly in the Maldives,Maldives,Seychelles,1125,1031,2,1,5,-5,1130,1026,170,184,2,-1,172,183,20,100,194
1031,Nov 24 2011,WC & Oce Cup q in Samoa,Samoa,Tonga,701,655,1,1,-8,8,693,663,220,218,-3,1,217,219,40,100,146
1032,Nov 25 2011,CECAFA Cup in Tanzania,Burundi,Somalia,1215,912,4,1,10,-10,1225,902,144,198,3,-1,147,197,40,0,303
1033,Nov 25 2011,CECAFA Cup in Tanzania,Uganda,Zanzibar,1542,1356,2,1,10,-10,1552,1346,71,122,2,-1,73,121,40,0,186
1034,Nov 26 2011,WC & Oce Cup q in Samoa,Samoa,Eastern Samoa,693,385,1,0,3,-3,696,382,213,234,2,0,215,234,20,0,308
1035,Nov 26 2011,CECAFA Cup in Tanzania,Tanzania,Rwanda,1318,1364,0,1,-23,23,1295,1387,142,104,-6,7,136,111,40,100,54
1036,Nov 26 2011,WC & Oce Cup q in Samoa,Tonga,Cook Islands,663,697,2,1,22,-22,685,675,217,223,1,-4,218,219,40,0,-34
1037,Nov 27 2011,CECAFA Cup in Tanzania,Burundi,Zanzibar,1225,1346,0,0,7,-7,1232,1339,147,129,0,-4,147,125,40,0,-121
1038,Nov 27 2011,CECAFA Cup in Tanzania,Zimbabwe,Djibouti,1384,795,2,0,2,-2,1386,793,113,207,0,0,113,207,40,0,589
1039,Nov 28 2011,CECAFA Cup in Tanzania,Ethiopia,Sudan,1307,1405,1,1,5,-5,1312,1400,126,107,3,0,129,107,40,0,-98
1040,Nov 28 2011,CECAFA Cup in Tanzania,Malawi,Kenya,1414,1330,2,0,23,-23,1437,1307,99,136,2,-4,101,132,40,0,84
1041,Nov 28 2011,CECAFA Cup in Tanzania,Uganda,Somalia,1552,902,4,0,2,-2,1554,900,71,197,1,0,72,197,40,0,650
1042,Nov 29 2011,Friendly in India,India,Zambia,1201,1522,0,5,-9,9,1192,1531,161,75,-3,2,158,77,20,100,-221
1043,Nov 29 2011,CECAFA Cup in Tanzania,Rwanda,Zimbabwe,1387,1386,2,0,30,-30,1417,1356,95,125,8,-6,103,119,40,0,1
1044,Nov 29 2011,CECAFA Cup in Tanzania,Tanzania,Djibouti,1295,793,3,0,2,-2,1297,791,132,207,2,0,134,207,20,0,502
1045,Nov 30 2011,CECAFA Cup in Tanzania,Kenya,Ethiopia,1307,1312,2,0,30,-30,1337,1282,120,145,6,-8,126,137,40,0,-5
1046,Nov 30 2011,CECAFA Cup in Tanzania,Malawi,Sudan,1437,1400,0,0,-2,2,1435,1402,101,108,0,0,101,108,30,0,37
1047,Dec 1 2011,CECAFA Cup in Tanzania,Burundi,Uganda,1232,1554,1,0,35,-35,1267,1519,135,88,6,-8,141,80,40,0,-322
1048,Dec 1 2011,CECAFA Cup in Tanzania,Zanzibar,Somalia,1339,900,3,0,5,-5,1344,895,117,199,4,-1,121,198,40,0,439
1049,Dec 2 2011,South Asian Championship in India,Bangladesh,Pakistan,988,884,0,0,-6,6,982,890,188,202,0,0,188,202,40,0,104
1050,Dec 2 2011,Friendly tournament in Suriname,Bonaire,Curaçao,1071,1103,3,1,25,-25,1096,1078,175,180,2,-2,177,178,30,0,-32
1051,Dec 2 2011,CECAFA Cup in Tanzania,Ethiopia,Malawi,1282,1435,1,1,8,-8,1290,1427,135,101,1,0,136,101,40,0,-153
1052,Dec 2 2011,South Asian Championship in India,Maldives,Nepal,1130,963,1,1,-9,9,1121,972,176,189,-2,1,174,190,40,0,167
1053,Dec 2 2011,CECAFA Cup in Tanzania,Rwanda,Djibouti,1417,791,5,2,2,-2,1419,789,103,207,0,0,103,207,40,0,626
1054,Dec 2 2011,Friendly tournament in Suriname,Suriname,Aruba,1204,927,0,0,-12,12,1192,939,160,189,-3,3,157,192,30,100,377
1055,Dec 3 2011,South Asian Championship in India,India,Afghanistan,1192,834,1,1,-17,17,1175,851,163,203,-3,1,160,204,40,100,458
1056,Dec 3 2011,South Asian Championship in India,Sri Lanka,Bhutan,891,564,3,0,9,-9,900,555,193,228,4,-1,197,227,40,0,327
1057,Dec 3 2011,CECAFA Cup in Tanzania,Sudan,Kenya,1402,1337,1,0,16,-16,1418,1321,100,130,4,-2,104,128,40,0,65
1058,Dec 3 2011,CECAFA Cup in Tanzania,Tanzania,Zimbabwe,1297,1356,1,2,-22,22,1275,1378,141,113,-4,3,137,116,40,100,41
1059,Dec 4 2011,Friendly tournament in Suriname,Aruba,Bonaire,939,1096,2,2,6,-6,945,1090,192,177,0,0,192,177,30,0,-157
1060,Dec 4 2011,South Asian Championship in India,Maldives,Pakistan,1121,890,0,0,-12,12,1109,902,176,192,-1,5,175,197,40,0,231
1061,Dec 4 2011,South Asian Championship in India,Nepal,Bangladesh,972,982,1,0,21,-21,993,961,186,194,2,-3,188,191,40,0,-10
1062,Dec 4 2011,Friendly tournament in Suriname,Suriname,Curaçao,1192,1078,2,0,10,-10,1202,1068,151,180,3,-1,154,179,20,0,114
1063,Dec 5 2011,South Asian Championship in India,Afghanistan,Sri Lanka,851,900,3,1,34,-34,885,866,200,210,2,-6,202,204,40,0,-49
1064,Dec 5 2011,South Asian Championship in India,India,Bhutan,1175,555,5,0,1,-1,1176,554,160,227,0,0,160,227,20,0,620
1065,Dec 5 2011,CECAFA Cup in Tanzania,Rwanda,Zanzibar,1419,1344,2,1,16,-16,1435,1328,101,133,1,-6,102,127,40,0,75
1066,Dec 5 2011,CECAFA Cup in Tanzania,Sudan,Burundi,1418,1267,2,0,18,-18,1436,1249,98,145,3,-2,101,143,40,0,151
1067,Dec 6 2011,Friendly in Bahrain,Bahrain,Palestine,1507,1169,0,1,-19,19,1488,1188,96,155,-5,4,91,159,20,100,438
1068,Dec 6 2011,South Asian Championship in India,Maldives,Bangladesh,1109,961,3,1,18,-18,1127,943,171,193,2,-1,173,192,40,0,148
1069,Dec 6 2011,South Asian Championship in India,Nepal,Pakistan,993,902,1,1,-5,5,988,907,188,195,0,1,188,196,20,100,191
1070,Dec 6 2011,CECAFA Cup in Tanzania,Tanzania,Malawi,1275,1427,1,0,23,-23,1298,1404,129,113,4,-5,133,108,40,100,-52
1071,Dec 6 2011,CECAFA Cup in Tanzania,Uganda,Zimbabwe,1519,1378,1,0,12,-12,1531,1366,72,120,4,-2,76,118,40,0,141
1072,Dec 7 2011,South Asian Championship in India,Afghanistan,Bhutan,885,554,8,1,12,-12,897,542,196,229,3,-1,199,228,40,0,331
1073,Dec 7 2011,South Asian Championship in India,India,Sri Lanka,1176,866,3,0,6,-6,1182,860,161,204,0,0,161,204,40,100,410
1074,Dec 8 2011,CECAFA Cup in Tanzania,Rwanda,Sudan,1435,1436,2,1,20,-20,1455,1416,96,105,3,-2,99,103,40,0,-1
1075,Dec 8 2011,CECAFA Cup in Tanzania,Tanzania,Uganda,1298,1531,1,3,-19,19,1279,1550,141,70,-4,3,137,73,40,100,-133
1076,Dec 9 2011,South Asian Championship in India,Afghanistan,Nepal,897,988,1,0,25,-25,922,963,193,192,3,-2,196,190,40,0,-91
1077,Dec 9 2011,South Asian Championship in India,India,Maldives,1182,1127,3,1,17,-17,1199,1110,149,177,6,-2,155,175,40,100,155
1078,Dec 10 2011,Pan Arab Games in Qatar,Qatar,Bahrain,1509,1488,2,2,-7,7,1502,1495,89,89,-2,1,87,90,40,100,121
1079,Dec 10 2011,CECAFA Cup in Tanzania,Rwanda,Uganda,1455,1550,2,2,5,-5,1460,1545,97,77,1,-2,98,75,40,0,-95
1080,Dec 10 2011,CECAFA Cup in Tanzania,Tanzania,Sudan,1279,1416,0,1,-18,18,1261,1434,143,101,-3,1,140,102,40,100,-37
1081,Dec 11 2011,Friendly in Cuba,Cuba,Costa Rica,1391,1645,1,1,4,-4,1395,1641,110,51,0,0,110,51,20,100,-154
1082,Dec 11 2011,South Asian Championship in India,India,Afghanistan,1199,922,4,0,8,-8,1207,914,151,196,2,0,153,196,40,100,377
1083,Dec 11 2011,Pan Arab Games in Qatar,Jordan,Palestine,1554,1188,4,1,8,-8,1562,1180,68,162,2,-1,70,161,40,0,366
1084,Dec 13 2011,Pan Arab Games in Qatar,Bahrain,Iraq,1495,1634,3,0,48,-48,1543,1586,62,72,14,-9,76,63,40,0,-139
1085,Dec 14 2011,Friendly in Angola,Angola,Cameroon,1484,1655,1,1,2,-2,1486,1653,91,47,1,0,92,47,20,100,-71
1086,Dec 14 2011,Pan Arab Games in Qatar,Libya,Palestine,1512,1180,1,1,-15,15,1497,1195,97,155,-7,3,90,158,40,0,332
1087,Dec 16 2011,Pan Arab Games in Qatar,Qatar,Iraq,1502,1586,0,0,-1,1,1501,1587,89,61,-1,1,88,62,30,100,16
1088,Dec 17 2011,Pan Arab Games in Qatar,Jordan,Libya,1562,1497,0,0,-4,4,1558,1501,70,86,0,2,70,88,20,100,165
1089,Dec 18 2011,Friendly in Angola,Angola,Zambia,1486,1531,1,0,8,-8,1494,1523,90,82,1,-2,91,80,20,100,55
1090,Dec 20 2011,Pan Arab Games in Qatar,Bahrain,Palestine,1543,1195,3,1,7,-7,1550,1188,70,162,3,-2,73,160,40,0,348
1091,Dec 20 2011,Pan Arab Games in Qatar,Jordan,Kuwait,1558,1550,2,0,29,-29,1587,1521,54,87,8,-7,62,80,40,0,8
1092,Dec 21 2011,Friendly in South Africa,Botswana,Lesotho,1411,1188,3,0,8,-8,1419,1180,103,162,1,-1,104,161,20,0,223
1093,Dec 21 2011,Friendly in Chile,Chile,Paraguay,1881,1788,3,2,5,-5,1886,1783,9,23,1,-1,10,22,20,100,193
1094,Dec 22 2011,Friendly in Angola,Angola,Namibia,1494,1296,0,0,-7,7,1487,1303,93,130,-1,2,92,132,20,100,298
1095,Dec 22 2011,Pan Arab Games in Qatar,Kuwait,Palestine,1521,1188,3,0,9,-9,1530,1179,76,162,2,-1,78,161,40,0,333
1096,Dec 22 2011,Friendly in Venezuela,Venezuela,Costa Rica,1737,1641,0,2,-23,23,1714,1664,40,43,-3,4,37,47,20,100,196
1097,Dec 23 2011,Pan Arab Games in Qatar,Bahrain,Jordan,1550,1587,1,0,22,-22,1572,1565,63,80,5,-9,68,71,40,0,-37
